ก.	k @@ 
กฎ	k o t^ 
กฎหมาย	k o t^ m aa j^ 
กฎหมายอาญา	k o t^ m aa j^ z aa j aa 
กฎเกณฑ์	k o t^ k ee n^ 
กด	k o t^ 
กดขี่	k o t^ kh ii 
กดดัน	k o t^ d a n^ 
กตัญญู	k a t a n^ j uu 
กติกา	k a t i k aa 
กทม.	k @@ th @@ m @@ 
กบฏ	k a b o t^ 
กมล	k a m o n^ 
กรกฎาคม	k a r a k^ k a d aa kh o m^ 
กรกฎาคม	k a r a k a d aa kh o m^ 
กรณี	k @@ r a n ii 
กรม	kr o m^ 
กรรม	k a m^ 
กรรมกร	k a m^ m a k @@ n^ 
กรรมการ	k a m^ m a k aa n^ 
กรรมพันธุ์	k a m^ m a ph a n^ 
กรรมวิธี	k a m^ m a w i th ii 
กรรมสิทธิ์	k a m^ m a s i t^ 
กรรมาธิการ	k a m^ m aa th i k aa n^ 
กรอ.	k @@ r @@ z @@ 
กรอบ	kr @@ p^ 
กระจก	kr a c o k^ 
กระจกเงา	kr a c o k^ ng a w^ 
กระจัดกระจาย	kr a c a t^ kr a c aa j^ 
กระจาบ	kr a c aa p^ 
กระจาย	kr a c aa j^ 
กระจ่าง	kr a c aa ng^ 
กระดูก	kr a d uu k^ 
กระตือรือร้น	kr a t vv r vv r o n^ 
กระตุก	kr a t u k^ 
กระตุ้น	kr a t u n^ 
กระทบ	kr a th o p^ 
กระทบกระทั่ง	kr a th o p^ kr a th a ng^ 
กระทบกระเทือน	kr a th o p^ kr a th vva n^ 
กระทรวง	kr a s uua ng^ 
กระทรวง	kr a s uua ng^  
กระทั่ง	kr a th a ng^ 
กระทำ	kr a th a m^ 
กระทู้	kr a th uu 
กระท่อม	kr a th @@ m^ 
กระนั้น	kr a n a n^ 
กระบวน	kr a b uua n^ 
กระบวนการ	kr a b uua n^ k aa n^ 
กระป๋อง	kr a p @ ng^ 
กระพือ	kr a ph vv 
กระมัง	kr a m a ng^ 
กระสุน	kr a s u n^ 
กระหาย	kr a h aa j^ 
กระเดียด	kr a d iia t^ 
กระเทือน	kr a th vva n^ 
กระแทก	kr a th xx k^ 
กระแส	kr a s xx 
กระโดด	kr a d oo t^ 
กระโน้น	kr a n oo n^ 
กระไร	kr a r a j^ 
กราบ	kr aa p^ 
กริยา	kr i j aa 
กรีซ	kr ii s^ 
กรีน	kr ii n^ 
กรุง	kr u ng^ 
กรุงเทพ	kr u ng^ th ee p^ 
กรุงเทพมหานคร	kr u ng^ th ee p^ m a h aa n a kh @@ n^ 
กรุณา	k a r u n aa 
กรุณาธิคุณ	k a r u n aa th i kh u n^ 
กลม	kl o m^ 
กลมกลืน	kl o m^ kl vv n^ 
กลยุทธ์	k o n^ l a j u t^ 
กลวิธาน	k o n^ l a w i th aa n^ 
กลวิธี	k o n^ l a w i th ii 
กลับ	kl a p^ 
กลับกลาย	kl a p^ kl aa j^ 
กลัว	kl uua 
กลั่นกรอง	kl a n^ kr @@ ng^ 
กลั้น	kl a n^ 
กลาง	kl aa ng^ 
กลางคืน	kl aa ng^ kh vv n^ 
กลางวัน	kl aa ng^ w a n^ 
กลาย	kl aa j^ 
กลาโหม	k a l aa h oo m^ 
กลิ่น	kl i n^ 
กลืน	kl vv n^ 
กลุ่ม	kl u m^ 
กลไก	k o n^ k a j^ 
กล่องเสียง	kl @ ng^ s iia ng^ 
กล่าว	kl aa w^ 
กล่าวขวัญ	kl aa w^ khw a n^ 
กล่าวคือ	kl aa w^ kh vv 
กล่าวว่า	kl aa w^ w aa 
กล่าวหา	kl aa w^ h aa 
กล่าวอ้าง	kl aa w^ z aa ng^ 
กล้า	kl aa 
กล้ามเนื้อ	kl aa m^ n vva 
กล้าหาญ	kl aa h aa n^ 
กวาดล้าง	kw aa t^ l aa ng^ 
กวี	k a w ii 
กวีนิพนธ์	k a w ii n i ph o n^ 
กว่า	kw aa 
กว้าง	kw aa ng^ 
กว้างขวาง	kw aa ng^ khw aa ng^ 
กว้าน	kw aa n^ 
กษัตริย์	k a s a t^ 
กษัยการ	k a s a j^ j a k aa n^ 
กสิกร	k a s i k @@ n^ 
กสิกรรม	k a s i k a m^ 
กอง	k @@ ng^ 
กองทหาร	k @@ ng^ th a h aa n^ 
กองทัพ	k @@ ng^ th a p^ 
กองทุน	k @@ ng^ th u n^ 
กองพัน	k @@ ng^ ph a n^ 
กอบกู้	k @@ p^ k uu 
กอบโกย	k @@ p^ k oo j^ 
กอร์บาชอฟ	k @@ b aa ch @@ p^ 
กะทันหัน	k a th a n^ h a n^ 
กะทูน	k a th uu n^ 
กะโหลก	k a l oo k^ 
กักกุม	k a k^ k u m^ 
กังวล	k a ng^ w o n^ 
กังวาล	k a ng^ w aa n^ 
กัณหา	k a n^ h aa 
กัด	k a t^ 
กัน	k a n^ 
กันยายน	k a n^ j aa j o n^ 
กันเอง	k a n^ z ee ng^ 
กันและกัน	k a n^ l x k a n^ 
กับ	k a p^ 
กัป	k a p^ 
กัมพูชา	k a m^ ph uu ch aa 
กั้น	k a n^ 
กาก	k aa k^ 
กาญจนบุรี	k aa n^ c a n a b u r ii 
กาม	k aa m^ 
กาย	k aa j^ 
กายภาพ	k aa j^ j a ph aa p^ 
การ	k aa n^ 
การค้า	k aa n^ kh aa 
การงาน	k aa n^ ng aa n^ 
การณ์	k aa n^ 
การดำเนิน	k aa n^ d a m^ n qq n^ 
การตลาด	k aa n^ t a l aa t^ 
การทหาร	k aa n^ th a h aa n^ 
การผลิต	k aa n^ ph a l i t^ 
การละคร	k aa n^ l a kh @@ n^ 
การวิจัย	k aa n^ w i c a j^ 
การศึกษา	k aa n^ s v k^ s aa 
การสัมมนา	k aa n^ s a m^ m a n aa 
การันต์	k aa r a n^ 
การุณยวนิช	k aa r u n^ j a w a n i t^ 
การเกษตร	k aa n^ k a s ee t^ 
การเงิน	k aa n^ ng q n^ 
การเมือง	k aa n^ m vva ng^ 
การได้ยิน	k aa n^ d aa j^ j i n^ 
กาล	k aa n^ 
กาลิโก	k aa l i k oo 
กาลเทศะ	k aa l a th ee s a 
กาลเวลา	k aa n^ w ee l aa 
กาแฟ	k aa f xx 
กำจัด	k a m^ c a t^ 
กำนัน	k a m^ n a n^ 
กำพร้า	k a m^ phr aa 
กำลัง	k a m^ l a ng^ 
กำลังจะ	k a m^ l a ng^ c a 
กำลังเอก	k a m^ l a ng^ z ee k^ 
กำลังใจ	k a m^ l a ng^ c a j^ 
กำสรวล	k a m^ s uua n^ 
กำหนด	k a m^ n o t^ 
กำหนดการ	k a m^ n o t^ k aa n^ 
กำเดา	k a m^ d a w^ 
กำเนิด	k a m^ n qq t^ 
กำไร	k a m^ r a j^ 
กิจ	k i t^ 
กิจกรรม	k i t^ c a k a m^ 
กิจการ	k i t^ c a k aa n^ 
กิจวัตร	k i t^ c a w a t^ 
กิตติ	k i t^ t i 
กิตติขจร	k i t^ t i kh a c @@ n^ 
กิน	k i n^ 
กินดี	k i n^ d ii 
กินอยู่	k i n^ j uu 
กิริยา	k i r i j aa 
กิเลส	k i l ee t^ 
กีดกัน	k ii t^ k a n^ 
กีดขวาง	k ii t^ khw aa ng^ 
กีฬา	k ii l aa 
กี่	k ii 
กึ่ง	k v ng^ 
กุม	k u m^ 
กุมภาพันธ์	k u m^ ph aa ph a n^ 
กุศล	k u s o n^ 
กุหลาบ	k u l aa p^ 
กุ้ง	k u ng^ 
กู	k uu 
กู้	k uu 
ก็	k @@ 
ก็ดี	k @@ d ii 
ก็ตาม	k @@ t aa m^ 
ก็ตามแต่	k @@ t aa m^ t xx 
ก็ได้	k @@ d a j^ 
ก็ได้	k @@ d aa j^ 
ก่อ	k @@ 
ก่อตั้ง	k @@ t a ng^ 
ก่อน	k @@ n^ 
ก่อนหน้า	k @@ n^ n aa 
ก่อนหน้านี้	k @@ n^ n aa n ii 
ก่อสร้าง	k @@ s aa ng^ 
ก้อน	k @@ n^ 
ก้อย	k @@ j^ 
ก้าว	k aa w^ 
ก้าวร้าว	k aa w^ r aa w^ 
ก้าวหน้า	k aa w^ n aa 
ก๊กมินตั๋ง	k o k^ m i n^ t a ng^ 
ก๊าซ	k aa t^ 
ก๋อง	k @ ng^ 
ข.	kh @@ 
ขจรประศาสน์	kh a c @@ n^ pr a s aa t^ 
ขจัด	kh a c a t^ 
ขณะ	kh a n a 
ขณะที่	kh a n a th ii 
ขณะนั้น	kh a n a n a n^ 
ขณะนี้	kh a n a n ii 
ขณะเดียวกัน	kh a n a d iia w^ k a n^ 
ขนบ	kh a n o p^ 
ขนมปัง	kh a n o m^ p a ng^ 
ขนส่ง	kh o n^ s o ng^ 
ขนาด	kh a n aa t^ 
ขบคิด	kh o p^ kh i t^ 
ขบวน	kh a b uua n^ 
ขบวนการ	kh a b uua n^ k aa n^ 
ขยะ	kh a j a 
ขยัน	kh a j a n^ 
ขยับ	kh a j a p^ 
ขยับขยาย	kh a j a p^ kh a j aa j^ 
ขยาย	kh a j aa j^ 
ขวด	kh uua t^ 
ขวนขวาย	kh uua n^ khw aa j^ 
ขวบ	kh uua p^ 
ขวัญ	khw a n^ 
ขวา	khw aa 
ขอ	kh @@ 
ของ	kh @@ ng^ 
ของชำ	kh @@ ng^ ch a m^ 
ของเล่น	kh @@ ng^ l e n^ 
ของเสีย	kh @@ ng^ s iia 
ของใช้	kh @@ ng^ ch a j^ 
ขอนแก่น	kh @@ n^ k x n^ 
ขอบข่าย	kh @@ p^ kh aa j^ 
ขอบคุณ	kh @@ p^ kh u n^ 
ขอบเขต	kh @@ p^ kh ee t^ 
ขอม	kh @@ m^ 
ขอร้อง	kh @@ r @@ ng^ 
ขัง	kh a ng^ 
ขัด	kh a t^ 
ขัดขวาง	kh a t^ khw aa ng^ 
ขัดขืน	kh a t^ kh vv n^ 
ขัดข้อง	kh a t^ kh @ ng^ 
ขัดสมาธิ	kh a t^ s a m aa t^ 
ขัดแย้ง	kh a t^ j xx ng^ 
ขัน	kh a n^ 
ขันธ์	kh a n^ 
ขับ	kh a p^ 
ขับถ่าย	kh a p^ th aa j^ 
ขั้น	kh a n^ 
ขั้นตอน	kh a n^ t @@ n^ 
ขั้นบันได	kh a n^ b a n^ d a j^ 
ขา	kh aa 
ขาด	kh aa t^ 
ขาดแคลน	kh aa t^ khl xx n^ 
ขานรับ	kh aa n^ r a p^ 
ขาย	kh aa j^ 
ขายตัว	kh aa j^ t uua 
ขายปลีก	kh aa j^ pl ii k^ 
ขาว	kh aa w^ 
ขาเข้า	kh aa kh a w^ 
ขีด	kh ii t^ 
ขีดสุด	kh ii t^ s u t^ 
ขีปนาวุธ	kh ii p a n aa w u t^ 
ขี่	kh ii 
ขี้เกียจ	kh ii k iia t^ 
ขึ้น	kh v n^ 
ขืน	kh vv n^ 
ขุด	kh u t^ 
ขุน	kh u n^ 
ขุนนาง	kh u n^ n aa ng^ 
ขูด	kh uu t^ 
ข่มขู่	kh o m^ kh uu 
ข่มเหง	kh o m^ h ee ng^ 
ข่าย	kh aa j^ 
ข่ายงาน	kh aa j^ ng aa n^ 
ข่าว	kh aa w^ 
ข่าวกรอง	kh aa w^ kr @@ ng^ 
ข่าวคราว	kh aa w^ khr aa w^ 
ข่าวลือ	kh aa w^ l vv 
ข่าวสาร	kh aa w^ s aa n^ 
ข้อ	kh @@ 
ข้อขัดแย้ง	kh @@ kh a t^ j xx ng^ 
ข้อความ	kh @@ khw aa m^ 
ข้อคิด	kh @@ kh i t^ 
ข้อง	kh @ ng^ 
ข้องคับ	kh @ ng^ kh a p^ 
ข้องใจ	kh @ ng^ c a j^ 
ข้อจำกัด	kh @@ c a m^ k a t^ 
ข้อดี	kh @@ d ii 
ข้อบังคับ	kh @@ b a ng^ kh a p^ 
ข้อมูล	kh @@ m uu n^ 
ข้อสงสัย	kh @@ s o ng^ s a j^ 
ข้อสรุป	kh @@ s a r u p^ 
ข้อสังเกต	kh @@ s a ng^ k ee t^ 
ข้อหา	kh @@ h aa 
ข้อห้าม	kh @@ h aa m^ 
ข้ออ้าง	kh @@ z aa ng^ 
ข้อเขียน	kh @@ kh iia n^ 
ข้อเท็จจริง	kh @@ th e t^ c i ng^ 
ข้อเรียกร้อง	kh @@ r iia k^ r @@ ng^ 
ข้อเสนอ	kh @@ s a n qq 
ข้อเสีย	kh @@ s iia 
ข้อแก้ตัว	kh @@ k xx t uua 
ข้อโต้แย้ง	kh @@ t oo j xx ng^ 
ข้าง	kh aa ng^ 
ข้างต้น	kh aa ng^ t o n^ 
ข้างนอก	kh aa ng^ n @@ k^ 
ข้างมาก	kh aa ng^ m aa k^ 
ข้างหน้า	kh aa ng^ n aa 
ข้างใน	kh aa ng^ n a j^ 
ข้าพเจ้า	kh aa ph a c a w^ 
ข้าม	kh aa m^ 
ข้าราชการ	kh aa r aa t^ ch a k aa n^ 
ข้าว	kh aa w^ 
ข้าวเปลือก	kh aa w^ pl vva k^ 
ข้าวเหนียว	kh aa w^ n iia w^ 
คง	kh o ng^ 
คงจะ	kh o ng^ c a 
คงทน	kh o ng^ th o n^ 
คงที่	kh o ng^ th ii 
คงสมพงษ์	kh o ng^ s o m^ ph o ng^ 
คณบดี	kh a n a b @@ d ii 
คณะ	kh a n a 
คณาจารย์	kh a n aa c aa n^ 
คดี	kh a d ii 
คติ	kh a t i 
คน	kh o n^ 
คนงาน	kh o n^ ng aa n^ 
คนป่วย	kh o n^ p uua j^ 
คนรัก	kh o n^ r a k^ 
คนร้าย	kh o n^ r aa j^ 
คนหนึ่ง	kh o n^ n v ng^ 
คนเรา	kh o n^ r a w^ 
คนใด	kh o n^ d a j^ 
คนใดคนหนึ่ง	kh o n^ d a j^ kh o n^ n v ng^ 
คนไข้	kh o n^ kh a j^ 
คบ	kh o p^ 
คบค้า	kh o p^ kh aa 
คบหา	kh o p^ h aa t^ 
คม	kh o m^ 
คมนาคม	kh a m a n aa kh o m^ 
ครบ	khr o p^ 
ครบถ้วน	khr o p^ th uua n^ 
ครม.	kh @@ r @@ m @@ 
ครรภ์	kh a n^ 
ครอง	khr @@ ng^ 
ครองชีพ	khr @@ ng^ ch ii p^ 
ครอบ	khr @@ p^ 
ครอบครอง	khr @@ p^ khr @@ ng^ 
ครอบครัว	khr @@ p^ khr uua 
ครอบคลุม	khr @@ p^ khl u m^ 
ครอบงำ	khr @@ p^ ng a m^ 
ครับ	khr a p^ 
ครัวเรือน	khr uua r vva n^ 
ครั้ง	khr a ng^ 
ครั้งคราว	khr a ng^ khr aa w^ 
ครั้งนั้น	khr a ng^ n a n^ 
ครั้งนี้	khr a ng^ n ii 
ครั้น	khr a n^ 
คราประยูร	khr aa pr a j uu n^ 
คราว	khr aa w^ 
คราวนี้	khr aa w^ n ii 
คริสตจักร	khr i t^ t a c a k^ 
คริสต์	khr i t^ 
คริสต์ศักราช	khr i t^ s a k^ k a r aa t^ 
ครึ่ง	khr v ng^ 
ครุสชอฟ	khr u s^ ch @@ f^ 
ครู	khr uu 
ครูบาอาจารย์	khr uu b aa z aa c aa n^ 
คร่าว	khr aa w^ 
คลอด	khl @@ t^ 
คลัง	khl a ng^ 
คลาดเคลื่อน	khl aa t^ khl vva n^ 
คลาย	khl aa j^ 
คลาสสิค	khl aa t^ s i k^ 
คลาสสิค	kl aa t^ s i k^ 
คลี่คลาย	khl ii khl aa j^ 
คลื่น	khl vv n^ 
คลุกคลี	khl u k^ khl ii 
คลุม	khl u m^ 
คลุมเครือ	khl u m^ khr vva 
คล่อง	khl @ ng^ 
คล่องแคล่ว	khl @ ng^ khl x w^ 
คล้อยตาม	khl @@ j^ t aa m^ 
คล้าย	khl aa j^ 
คล้ายคลึง	khl aa j^ khl v ng^ 
คล้ำ	khl a m^ 
ควง	kh uua ng^ 
ควบกล้ำ	kh uua p^ kl a m^ 
ควบคุม	kh uua p^ kh u m^ 
ควบคู่	kh uua p^ kh uu 
ควร	kh uua n^ 
ความ	khw aa m^ 
ความคิด	khw aa m^ kh i t^ 
ความจริง	khw aa m^ c i ng^ 
ความจำ	khw aa m^ c a m^ 
ความดัน	khw aa m^ d a n^ 
ความผิด	khw aa m^ ph i t^ 
ความหมาย	khw aa m^ m aa j^ 
ความเห็น	khw aa m^ h e n^ 
คอมพิวเตอร์	kh @ m^ ph i w^ t qq 
คอมมิวนิสต์	kh @ m^ m i w^ n i t^ 
คอมมิวนิสต์	kh @@ m^ m i w^ n i t^ 
คอย	kh @@ j^ 
คอร์รัปชั่น	kh @@ r a p^ ch a n^ 
คะ	kh a 
คะเน	kh a n ee 
คะแนน	kh a n xx n^ 
คะแนนเสียง	kh a n xx n^ s iia ng^ 
คัด	kh a t^ 
คัดค้าน	kh a t^ kh aa n^ 
คัดลอก	kh a t^ l @@ k^ 
คัดเลือก	kh a t^ l vva k^ 
คับ	kh a p^ 
คับข้อง	kh a p^ kh @ ng^ 
คับแคบ	kh a p^ kh xx p^ 
คับใจ	kh a p^ c a j^ 
คัมภีร์	kh a m^ ph ii 
คั่งค้าง	kh a ng^ kh aa ng^ 
คาด	kh aa t^ 
คาดการณ์	kh aa t^ k aa n^ 
คาดคิด	kh aa t^ kh i t^ 
คาดฝัน	kh aa t^ f a n^ 
คาดหมาย	kh aa t^ m aa j^ 
คาดหวัง	kh aa t^ w a ng^ 
คาถา	kh aa th aa 
คาน	kh aa n^ 
คาบเกี่ยว	kh aa p^ k iia w^ 
คารามาซอฟ	kh aa r aa m aa s @@ p^ 
คาร์บอนไดออกไซด์	kh aa b @ n^ d a j^ z @ k^ s aa j^ 
คาโบนิคแอสิด	kh aa b oo n i k^ z xx s i t^ 
คาโปน	kh aa p oo n^ 
คำ	kh a m^ 
คำขาด	kh a m^ kh aa t^ 
คำตอบ	kh a m^ t @@ p^ 
คำถาม	kh a m^ th aa m^ 
คำนึง	kh a m^ n v ng^ 
คำปรึกษา	kh a m^ pr v k^ s aa 
คำพูด	kh a m^ ph uu t^ 
คำศัพท์	kh a m^ s a p^ 
คำสอน	kh a m^ s @@ n^ 
คำสั่ง	kh a m^ s a ng^ 
คำอธิบาย	kh a m^ z a th i b aa j^ 
คิด	kh i t^ 
คิดค้น	kh i t^ kh o n^ 
คิดถึง	kh i t^ th v ng^ 
คิดเห็น	kh i t^ h e n^ 
คิว	kh i w^ 
คีบ	kh ii p^ 
คึกฤทธิ์	kh v k^ r i t^ 
คืน	kh vv n^ 
คืบหน้า	kh vv p^ n aa 
คือ	kh vv 
คุก	kh u k^ 
คุกคาม	kh u k^ kh aa m^ 
คุณ	kh u n^ 
คุณค่า	kh u n^ kh aa 
คุณธรรม	kh u n^ n a th a m^ 
คุณประโยชน์	kh u n^ pr a j oo t^ 
คุณภาพ	kh u n^ n a ph aa p^ 
คุณลักษณะ	kh u n^ n a l a k^ s a n a 
คุณศัพท์	kh u n^ n a s a p^ 
คุณสมบัติ	kh u n^ n a s o m^ b a t^ 
คุณหญิง	kh u n^ j i ng^ 
คุณูปการ	kh u n uu p a k aa n^ 
คุม	kh u m^ 
คุรุสภา	kh u r u s a ph aa 
คุ้น	kh u n^ 
คุ้นเคย	kh u n^ kh qq j^ 
คุ้ม	kh u m^ 
คุ้มกัน	kh u m^ k a n^ 
คุ้มครอง	kh u m^ khr @@ ng^ 
คุ้มค่า	kh u m^ kh aa 
คูน	kh uu n^ 
คูเวต	kh uu w ee t^ 
คู่	kh uu 
คู่ครอง	kh uu khr @@ ng^ 
คู่ค้า	kh uu kh aa 
คู่มือ	kh uu m vv 
ค่อน	kh @@ n^ 
ค่อนข้าง	kh @ n^ kh aa ng^ 
ค่อย	kh @ j^ 
ค่อย	kh @@ j^ 
ค่า	kh aa 
ค่าจ้าง	kh aa c aa ng^ 
ค่านิยม	kh aa n i j o m^ 
ค่าย	kh aa j^ 
ค่าเช่า	kh aa ch a w^ 
ค่าแรง	kh aa r xx ng^ 
ค่าใช้จ่าย	kh aa ch a j^ c aa j^ 
ค่ำคืน	kh a m^ kh vv n^ 
ค้น	kh o n^ 
ค้นคว้า	kh o n^ khw aa 
ค้นพบ	kh o n^ ph o p^ 
ค้นหา	kh o n^ h aa 
ค้า	kh aa 
ค้าง	kh aa ng^ 
ค้าน	kh aa n^ 
ค้ำ	kh a m^ 
ฆ่า	kh aa 
งง	ng o ng^ 
งด	ng o t^ 
งดงาม	ng o t^ ng aa m^ 
งดเว้น	ng o t^ w e n^ 
งบ	ng o p^ 
งบประมาณ	ng o p^ pr a m aa n^ 
งมงาย	ng o m^ ng aa j^ 
งอก	ng @@ k^ 
งอกงาม	ng @@ k^ ng aa m^ 
งาน	ng aa n^ 
งาม	ng aa m^ 
งูเห่า	ng uu h a w^ 
ง่าม	ng aa m^ 
ง่าย	ng aa j^ 
ง่ายดาย	ng aa j^ d aa j^ 
จ.	c @@ 
จ.	c a ng^ w a t^ 
จง	c o ng^ 
จงรัก	c o ng^ r a k^ 
จงใจ	c o ng^ c a j^ 
จด	c o t^ 
จดจำ	c o t^ c a m^ 
จดหมาย	c o t^ m aa j^ 
จดหมายเหตุ	c o t^ m aa j^ h ee t^ 
จตุจักร	c a t u c a k^ 
จน	c o n^ 
จนกระทั่ง	c o n^ kr a th a ng^ 
จนกว่า	c o n^ kw aa 
จนถึง	c o n^ th v ng^ 
จบ	c o p^ 
จปร.	c @@ p @@ r @@ 
จม	c o m^ 
จมูก	c a m uu k^ 
จมูก	c a m uu k^ 
จรรยา	c a n^ j aa 
จระเข้	c @@ r a kh ee 
จริง	c i ng^ 
จริงจัง	c i ng^ c a ng^ 
จริงอยู่	c i ng^ j uu 
จริงใจ	c i ng^ c a j^ 
จริยธรรม	c a r i j a th a m^ 
จริยศาสตร์	c a r i j a s aa t^ 
จริยศึกษา	c a r i j a s v k^ s aa 
จอ	c @@ 
จอด	c @@ t^ 
จอมพล	c @@ m^ ph o n^ 
จอร์จ	c @@ t^ 
จะ	c a 
จัก	c a k^ 
จักร	c a k^ 
จักรวาล	c a k^ kr a w aa n^ 
จักรๆ	c a k^ c a k^ 
จังหวะ	c a ng^ w a 
จังหวัด	c a ng^ w a t^ 
จัด	c a t^ 
จัดการ	c a t^ k aa n^ 
จัดตั้ง	c a t^ t a ng^ 
จัดสรร	c a t^ s a n^ 
จัดหา	c a t^ h aa 
จัดเจน	c a t^ c ee n^ 
จัดแต่ง	c a t^ t x ng^ 
จัดแสดง	c a t^ s a d xx ng^ 
จันทร์	c a n^ 
จันท์เทวี	c a n^ th ee w ii 
จับ	c a p^ 
จับกุม	c a p^ k u m^ 
จับคู่	c a p^ kh uu 
จับต้อง	c a p^ t @ ng^ 
จาก	c aa k^ 
จากนั้น	c aa k^ n a n^ 
จาง	c aa ng^ 
จาน	c aa n^ 
จารีต	c aa r ii t^ 
จารึก	c aa r v k^ 
จำ	c a m^ 
จำกัด	c a m^ k a t^ 
จำคุก	c a m^ kh u k^ 
จำนงศรี	c a m^ n o ng^ s ii 
จำนน	c a m^ n o n^ 
จำนวน	c a m^ n uua n^ 
จำนวนเต็ม	c a m^ n uua n^ t e m^ 
จำยอม	c a m^ j @@ m^ 
จำลอง	c a m^ l @@ ng^ 
จำหน่าย	c a m^ n aa j^ 
จำเจ	c a m^ c ee 
จำเป็น	c a m^ p e n^ 
จำแนก	c a m^ n xx k^ 
จิต	c i t^ 
จิตรกร	c i t^ tr a k @@ n^ 
จิตรกรรม	c i t^ tr a k a m^ 
จิตวิทยา	c i t^ t a w i t^ th a j aa 
จิตวิเคราะห์	c i t^ t a w i khr @ 
จิตสำนึก	c i t^ s a m^ n v k^ 
จิตเภท	c i t^ t a ph ee t^ 
จิตเวช	c i t^ t a w ee t^ 
จิตแพทย์	c i t^ t a ph xx t^ 
จิตใจ	c i t^ c a j^ 
จินดา	c i n^ d aa 
จิรโรจน์	c i r a r oo t^ 
จิ่งกังซาน	c i ng^ k a ng^ s aa n^ 
จี	c ii 
จีน	c ii n^ 
จีเซลซาฟ	c ii s e l^ s aa f^ 
จีเมนซาฟ	c ii m ee n^ s aa f^ 
จี้	c ii 
จึง	c v ng^ 
จุด	c u t^ 
จุดจบ	c u t^ c o p^ 
จุดประสงค์	c u t^ pr a s o ng^ 
จุดมุ่งหมาย	c u t^ m u ng^ m aa j^ 
จุดยืน	c u t^ j vv n^ 
จุดสำคัญ	c u t^ s a m^ kh a n^ 
จุดหมาย	c u t^ m aa j^ 
จุดเด่น	c u t^ d e n^ 
จุลจอมเกล้า	c u n^ l a c @@ m^ kl aa w^ 
จุลละทรัพย์	c u n^ l a s a p^ 
จูงใจ	c uu ng^ c a j^ 
จู่โจม	c uu c oo m^ 
จ่อ	c @@ 
จ่าย	c aa j^ 
จ้อย	c @ j^ 
จ้าง	c aa ng^ 
จ๋อย	c @ j^ 
ฉกรรจ์	ch a k a n^ 
ฉบับ	ch a b a p^ 
ฉลาก	ch a l aa k^ 
ฉลาด	ch a l aa t^ 
ฉลุ	ch a l u 
ฉวย	ch uua j^ 
ฉะนั้น	ch a n a n^ 
ฉัน	ch a n^ 
ฉันนั้น	ch a n^ n a n^ 
ฉันใด	ch a n^ d a j^ 
ฉับพลัน	ch a p^ phl a n^ 
ฉับไว	ch a p^ w a j^ 
ฉาก	ch aa k^ 
ฉาบฉวย	ch aa p^ ch uua j^ 
ฉาย	ch aa j^ 
ฉีดยา	ch ii t^ j aa 
ฉุกคิด	ch u k^ kh i t^ 
ฉ้อฉล	ch @@ ch o n^ 
ชน	ch o n^ 
ชนชั้น	ch o n^ ch a n^ 
ชนชั้นนำ	ch o n^ ch a n^ n a m^ 
ชนชาติ	ch o n^ ch aa t^ 
ชนบท	ch o n^ n a b o t^ 
ชนวน	ch a n uua n^ 
ชนะ	ch a n a 
ชนิด	ch a n i t^ 
ชม	ch o m^ 
ชมชอบ	ch o m^ ch @@ p^ 
ชมเชย	ch o m^ ch qq j^ 
ชรา	ch a r aa 
ชลบุรี	ch o n^ b u r ii 
ชลประทาน	ch o n^ pr a th aa n^ 
ชวน	ch uua n^ 
ชวลิต	ch a w a l i t^ 
ชวา	ch a w aa 
ชอตต์	ch @ t^ 
ชอบ	ch @@ p^ 
ชอบธรรม	ch @@ p^ th a m^ 
ชอบพอ	ch @@ p^ ph @@ 
ชะงัก	ch a ng a k^ 
ชะงักงัน	ch a ng a k^ ng a n^ 
ชะตา	ch a t aa 
ชะตากรรม	ch a t aa k a m^ 
ชะลอ	ch a l @@ 
ชะล้าง	ch a l aa ng^ 
ชัก	ch a k^ 
ชักจูง	ch a k^ c uu ng^ 
ชักชวน	ch a k^ ch uua n^ 
ชักนำ	ch a k^ n a m^ 
ชัด	ch a t^ 
ชัดเจน	ch a t^ c ee n^ 
ชัดแจ้ง	ch a t^ c xx ng^ 
ชัน	ch a n^ 
ชัยชนะ	ch a j^ ch a n a 
ชัยนาม	ch a j^ n aa m^ 
ชัยภูมิ	ch a j^ j a ph uu m^ 
ชัยวัฒน์	ch a j^ w a t^ 
ชั่ง	ch a ng^ 
ชั่ว	ch uua 
ชั่วคราว	ch uua khr aa w^ 
ชั่วโมง	ch uua m oo ng^ 
ชั้น	ch a n^ 
ชั้นปี	ch a n^ p ii 
ชั้นผู้ใหญ่	ch a n^ ph uu j a j^ 
ชาญ	ch aa n^ 
ชาญวิทย์	ch aa n^ w i t^ 
ชาติ	ch aa t^ 
ชาติชาย	ch aa t^ ch aa j^ 
ชาตินิยม	ch aa t^ n i j o m^ 
ชาติพันธุ์	ch aa t^ ph a n^ 
ชาติไทย	ch aa t^ th a j^ 
ชาย	ch aa j^ 
ชายคา	ch aa j^ kh aa 
ชายฝั่ง	ch aa j^ f a ng^ 
ชายเลน	ch aa j^ l ee n^ 
ชายแดน	ch aa j^ d xx n^ 
ชาว	ch aa w^ 
ชาวนา	ch aa w^ n aa 
ชาวบ้าน	ch aa w^ b aa n^ 
ชาวเกาะ	ch aa w^ k @ 
ชาวเขา	ch aa w^ kh a w^ 
ชาวเมือง	ch aa w^ m vva ng^ 
ชาวไทย	ch aa w^ th a j^ 
ชาวไร่	ch aa w^ r a j^ 
ชำนาญ	ch a m^ n aa n^ 
ชำนิชำนาญ	ch a m^ n i ch a m^ n aa n^ 
ชำระ	ch a m^ r a 
ชิง	ch i ng^ 
ชิงชัง	ch i ng^ ch a ng^ 
ชิด	ch i t^ 
ชิดชอบ	ch i t^ ch @@ p^ 
ชิดพงษ์	ch i t^ ph o ng^ 
ชิลี	ch i l ii 
ชิ้น	ch i n^ 
ชิ้นส่วน	ch i n^ s uua n^ 
ชีพ	ch ii p^ 
ชีพจร	ch ii p^ ph a c @@ n^ 
ชีวภาพ	ch ii w a ph aa p^ 
ชีววิทยา	ch ii w a w i t^ th a j aa 
ชีวิต	ch ii w i t^ 
ชีวิตชีวา	ch ii w i t^ ch ii w aa 
ชีวเคมี	ch ii w a kh ee m ii 
ชี้	ch ii 
ชี้ขาด	ch ii kh aa t^ 
ชี้นำ	ch ii n a m^ 
ชี้แจง	ch ii c xx ng^ 
ชื่นชม	ch vv n^ ch o m^ 
ชื่อ	ch vv 
ชื่อดัง	ch vv d a ng^ 
ชื่อเสียง	ch vv s iia ng^ 
ชุกชุม	ch u k^ ch u m^ 
ชุณหะวัณ	ch u n^ h a w a n^ 
ชุด	ch u t^ 
ชุดคำสั่ง	ch u t^ kh a m^ s a ng^ 
ชุมชน	ch u m^ ch o n^ 
ชุมนุม	ch u m^ n u m^ 
ชุมแพ	ch u m^ ph xx 
ชูศักดิ์	ch uu s a k^ 
ชู้สาว	ch uu s aa w^ 
ช่วง	ch uua ng^ 
ช่วงชิง	ch uua ng^ ch i ng^ 
ช่วย	ch uua j^ 
ช่วยเหลือ	ch uua j^ l vva 
ช่อง	ch @@ ng^ 
ช่องทาง	ch @ ng^ th aa ng^ 
ช่องว่าง	ch @ ng^ w aa ng^ 
ช่าง	ch a ng^ 
ช้า	ch aa 
ช้าง	ch aa ng^ 
ช้านาน	ch aa n aa n^ 
ซอย	s @@ j^ 
ซอสสมา	s @@ t^ s a m aa 
ซักถาม	s a k^ th aa m^ 
ซัดดัม	s a t^ d a m^ 
ซับซ้อน	s a p^ s @@ n^ 
ซาบซึ้ง	s aa p^ s v ng^ 
ซาร์ทร์	s aa t^ 
ซาลิน่า	s aa l i n aa 
ซาอุดิอาระเบีย	s aa z u d i z aa r a b iia 
ซิ	s i 
ซิซิลี	s i s i l ii 
ซี	s ii 
ซีก	s ii k^ 
ซีกโลก	s ii k^ l oo k^ 
ซีพี	s ii ph ii 
ซีไรต์	s ii r a j^ 
ซึม	s v m^ 
ซึ่ง	s v ng^ 
ซึ่งกันและกัน	s v ng^ k a n^ l x k a n^ 
ซื่อ	s vv 
ซื่อตรง	s vv tr o ng^ 
ซื่อสัตย์	s vv s a t^ 
ซื้อ	s vv 
ซื้อขาย	s vv kh aa j^ 
ซื้อหา	s vv h aa 
ซุก	s u k^ 
ซุกซ่อน	s u k^ s @@ n^ 
ซ่อนเร้น	s @@ n^ r e n^ 
ซ่อม	s @ m^ 
ซ่อมแซม	s @ m^ s xx m^ 
ซ้อน	s @@ n^ 
ซ้าย	s aa j^ 
ซ้ำ	s a m^ 
ซ้ำซ้อน	s a m^ s @@ n^ 
ซ้ำร้าย	s a m^ r aa j^ 
ญัตติ	j a t^ t i 
ญาณ	j aa n^ 
ญาติ	j aa t^ 
ญี่ปุ่น	j ii p u n^ 
ฐาน	th aa n^ 
ฐานกรณ์	th aa n^ k @@ n^ 
ฐานะ	th aa n a 
ณรงค์	n a r o ng^ 
ดงใหญ่	d o ng^ j a j^ 
ดนตรี	d o n^ tr ii 
ดม	d o m^ 
ดวง	d uua ng^ 
ดวงดาว	d uua ng^ d aa w^ 
ดวงมน	d uua ng^ m o n^ 
ดวงอาทิตย์	d uua ng^ z aa th i t^ 
ดอก	d @@ k^ 
ดอกไม้	d @@ k^ m aa j^ 
ดอน	d @@ n^ 
ดอลลาร์	d @ n^ l aa 
ดอสโตเยฟสกี	d @@ t^ t oo j ee p^ s a k ii 
ดัก	d a k^ 
ดัง	d a ng^ 
ดังกล่าว	d a ng^ kl aa w^ 
ดังต่อไปนี้	d a ng^ t @@ p a j^ n ii 
ดังที่	d a ng^ th ii 
ดังนั้น	d a ng^ n a n^ 
ดังนี้	d a ng^ n ii 
ดังเดิม	d a ng^ d qq m^ 
ดัดแปลง	d a t^ pl xx ng^ 
ดัตช์	d a t^ 
ดับทุกข์	d a p^ th u k^ 
ดั่ง	d a ng^ 
ดั่งนี้	d a ng^ n ii 
ดั้งเดิม	d a ng^ d qq m^ 
ดาราศาสตร์	d aa r aa s aa t^ 
ดาว	d aa w^ 
ดำ	d a m^ 
ดำรง	d a m^ r o ng^ 
ดำเนิน	d a m^ n qq n^ 
ดำเนินการ	d a m^ n qq n^ k aa n^ 
ดำเนินงาน	d a m^ n qq n^ ng aa n^ 
ดิฉัน	d i ch a n^ 
ดิน	d i n^ 
ดินแดน	d i n^ d xx n^ 
ดิษฐพันธุ์	d i t^ th a ph a n^ 
ดิเรก	d i r ee k^ 
ดิ่ง	d i ng^ 
ดิ้น	d i n^ 
ดิ้นรน	d i n^ r o n^ 
ดี	d ii 
ดีดีที	d ii d ii th ii 
ดีเด่น	d ii d e n^ 
ดีใจ	d ii c a j^ 
ดึก	d v k^ 
ดึกดำบรรพ์	d v k^ d a m^ b a n^ 
ดึง	d v ng^ 
ดื่ม	d vv m^ 
ดื้อดึง	d vv d v ng^ 
ดุ	d u 
ดุจ	d u t^ 
ดุน	d u n^ 
ดุล	d u n^ 
ดุลพินิจ	d u n^ ph i n i t^ 
ดุลยภาพ	d u n^ l a j a ph aa p^ 
ดุลอำนาจ	d u n^ z a m^ n aa t^ 
ดุเดือด	d u d vva t^ 
ดุ้น	d u n^ 
ดู	d uu 
ดูจะ	d uu c a 
ดูด	d uu t^ 
ดูถูก	d uu th uu k^ 
ดูหมิ่น	d uu m i n^ 
ดูเหมือน	d uu m vva n^ 
ดูเหมือนว่า	d uu m vva n^ w aa 
ดูแล	d uu l xx 
ด็อกเตอร์	d @ k^ t qq 
ด็อกเตอร์	d o k^ t qq 
ด่วน	d uua n^ 
ด่าง	d aa ng^ 
ด้น	d o n^ 
ด้วย	d uua j^ 
ด้วยว่า	d uua j^ w aa 
ด้วยเหตุที่	d uua j^ h ee t^ th ii 
ด้วยเหตุนี้	d uua j^ h ee t^ n ii 
ด้อย	d @ j^ 
ด้อย	d @@ j^ 
ด้อยพัฒนา	d @ j^ ph a t^ th a n aa 
ด้าน	d aa n^ 
ตก	t o k^ 
ตกต่ำ	t o k^ t a m^ 
ตกทอด	t o k^ th @@ t^ 
ตกยาก	t o k^ j aa k^ 
ตกลง	t o k^ l o ng^ 
ตกใจ	t o k^ c a j^ 
ตน	t o n^ 
ตนเอง	t o n^ z ee ng^ 
ตรง	tr o ng^ 
ตรงกันข้าม	tr o ng^ k a n^ kh aa m^ 
ตรงข้าม	tr o ng^ kh aa m^ 
ตรงไปตรงมา	tr o ng^ p a j^ tr o ng^ m aa 
ตรรกวิทยา	t a k^ k a w i t^ th a j aa 
ตรวจ	tr uua t^ 
ตรวจการณ์	tr uua t^ k aa n^ 
ตรวจจับ	tr uua t^ c a p^ 
ตรวจสอบ	tr uua t^ s @@ p^ 
ตระกูล	tr a k uu n^ 
ตระหนก	tr a n o k^ 
ตระหนัก	tr a n a k^ 
ตระเตรียม	tr a tr iia m^ 
ตรัส	tr a t^ 
ตรา	tr aa 
ตราบ	tr aa p^ 
ตราหน้า	tr aa n aa 
ตรี	tr ii 
ตรุษจีน	tr u t^ c ii n^ 
ตลก	t a l o k^ 
ตลอด	t a l @@ t^ 
ตลอดจน	t a l @@ t^ c o n^ 
ตลอดมา	t a l @@ t^ m aa 
ตลอดไป	t a l @@ t^ p a j^ 
ตลาด	t a l aa t^ 
ตลาดมืด	t a l aa t^ m vv t^ 
ตวง	t uua ng^ 
ตอน	t @@ n^ 
ตอนนั้น	t @@ n^ n a n^ 
ตอนนี้	t @@ n^ n ii 
ตอนแรก	t @@ n^ r xx k^ 
ตอบ	t @@ p^ 
ตอบสนอง	t @@ p^ s a n @@ ng^ 
ตอบแทน	t @@ p^ th xx n^ 
ตอบโต้	t @@ p^ t oo 
ตะกวด	t a k uua t^ 
ตะกั่ว	t a k uua 
ตะราง	t a r aa ng^ 
ตะวัน	t a w a n^ 
ตะวันตก	t a w a n^ t o k^ 
ตะวันออก	t a w a n^ z @@ k^ 
ตะวันออกกลาง	t a w a n^ z @@ k^ kl aa ng^ 
ตะวันออกเฉียงเหนือ	t a w a n^ z @@ k^ ch iia ng^ n vva 
ตะวันออกเฉียงใต้	t a w a n^ z @@ k^ ch iia ng^ t aa j^ 
ตะเข็บ	t a kh e p^ 
ตัก	t a k^ 
ตักตวง	t a k^ t uua ng^ 
ตักเตือน	t a k^ t vva n^ 
ตัณหา	t a n^ h aa 
ตัด	t a t^ 
ตัดสิน	t a t^ s i n^ 
ตัดสินใจ	t a t^ s i n^ c a j^ 
ตัน	t a n^ 
ตับ	t a p^ 
ตัว	t uua 
ตัวการ	t uua k aa n^ 
ตัวตน	t uua t o n^ 
ตัวนำ	t uua n a m^ 
ตัวประกอบ	t uua pr a k @@ p^ 
ตัวละคร	t uua l a kh @@ n^ 
ตัวสะกด	t uua s a k o t^ 
ตัวหนังสือ	t uua n a ng^ s vv 
ตัวอย่าง	t uua j aa ng^ 
ตัวอ่อน	t uua z @@ n^ 
ตัวเมือง	t uua m vva ng^ 
ตัวเลข	t uua l ee k^ 
ตัวเอก	t uua z ee k^ 
ตัวเอง	t uua z ee ng^ 
ตัวแทน	t uua th xx n^ 
ตัวแปร	t uua pr xx 
ตั้ง	t a ng^ 
ตั้งมั่น	t a ng^ m a n^ 
ตั้งอยู่	t a ng^ j uu 
ตั้งแต่	t a ng^ t xx 
ตั้งใจ	t a ng^ c a j^ 
ตา	t aa 
ตาด	t aa t^ 
ตาทัพ	t aa th a p^ 
ตาม	t aa m^ 
ตามพรลิงค์	t aa m^ ph @@ n^ l i ng^ 
ตามแต่	t aa m^ t xx 
ตามใจ	t aa m^ c a j^ 
ตาย	t aa j^ 
ตายตัว	t aa j^ t uua 
ตาราง	t aa r aa ng^ 
ตำนาน	t a m^ n aa n^ 
ตำรวจ	t a m^ r uua t^ 
ตำรับตำรา	t a m^ r a p^ t a m^ r aa 
ตำรา	t a m^ r aa 
ตำหนัก	t a m^ n a k^ 
ตำหนิ	t a m^ n i 
ตำแหน่ง	t a m^ n x ng^ 
ตำแหน่ง	t a m^ n xx ng^ 
ติณสูลานนท์	t i n^ n a s uu l aa n o n^ 
ติด	t i t^ 
ติดขัด	t i t^ kh a t^ 
ติดตั้ง	t i t^ t a ng^ 
ติดตาม	t i t^ t aa m^ 
ติดต่อ	t i t^ t @@ 
ติดยา	t i t^ j aa 
ติเตียน	t i t iia n^ 
ตี	t ii 
ตีความ	t ii khw aa m^ 
ตีน	t ii n^ 
ตีพิมพ์	t ii ph i m^ 
ตีแผ่	t ii ph xx 
ตึก	t v k^ 
ตึงเครียด	t v ng^ khr iia t^ 
ตื่น	t vv n^ 
ตื่นตัว	t vv n^ t uua 
ตื่นเต้น	t vv n^ t e n^ 
ตื้น	t vv n^ 
ตุลาการ	t u l aa k aa n^ 
ตุลาคม	t u l aa kh o m^ 
ตุ่ม	t u m^ 
ต่อ	t @@ 
ต่อจากนั้น	t @@ c aa k^ n a n^ 
ต่อต้าน	t @@ t aa n^ 
ต่อม	t @ m^ 
ต่อม	t @@ m^ 
ต่อมา	t @@ m aa 
ต่อรอง	t @@ r @@ ng^ 
ต่อสู้	t @@ s uu 
ต่อเนื่อง	t @@ n vva ng^ 
ต่อเมื่อ	t @@ m vva 
ต่อไป	t @@ p a j^ 
ต่อไปนี้	t @@ p a j^ n ii 
ต่าง	t aa ng^ 
ต่างกัน	t aa ng^ k a n^ 
ต่างจังหวัด	t aa ng^ c a ng^ w a t^ 
ต่างชาติ	t aa ng^ ch aa t^ 
ต่างประเทศ	t aa ng^ pr a th ee t^ 
ต่างหาก	t aa ng^ h aa k^ 
ต่ำ	t a m^ 
ต่ำสุด	t a m^ s u t^ 
ต้น	t o n^ 
ต้นกำเนิด	t o n^ k a m^ n qq t^ 
ต้นฉบับ	t o n^ ch a b a p^ 
ต้นทุน	t o n^ th u n^ 
ต้นน้ำ	t o n^ n aa m^ 
ต้นเหตุ	t o n^ h ee t^ 
ต้นแบบ	t o n^ b xx p^ 
ต้นไม้	t o n^ m aa j^ 
ต้วมเตี้ยม	t uua m^ t iia m^ 
ต้อ	t @@ 
ต้อง	 t @ ng^ 
ต้อง	t @ ng^ 
ต้องกัน	t @ ng^ k a n^ 
ต้องการ	t @ ng^ k aa n^ 
ต้องห้าม	t @ ng^ h aa m^ 
ต้อนรับ	t @@ n^ r a p^ 
ต้านทาน	t aa n^ th aa n^ 
ถกเถียง	th o k^ th iia ng^ 
ถดถอย	th o t^ th @ j^ 
ถนน	th a n o n^ 
ถนอม	th a n @@ m^ 
ถนัด	th a n a t^ 
ถล่ม	th a l o m^ 
ถวาย	th a w aa j^ 
ถอน	th @@ n^ 
ถอย	th @ j^ 
ถัด	th a t^ 
ถากถาง	th aa k^ th aa ng^ 
ถาม	th aa m^ 
ถาวร	th aa w @@ n^ 
ถิ่น	th i n^ 
ถิ่นฐาน	th i n^ th aa n^ 
ถีบ	th ii p^ 
ถี่	th ii 
ถี่ถ้วน	th ii th uua n^ 
ถึง	th v ng^ 
ถึงกระนั้น	th v ng^ kr a n a n^ 
ถึงแม้	th v ng^ m xx 
ถึงแม้ว่า	th v ng^ m xx w aa 
ถือ	th vv 
ถือกำเนิด	th vv k a m^ n qq t^ 
ถูก	th uu k^ 
ถูกต้อง	th uu k^ t @ ng^ 
ถ่วง	th uua ng^ 
ถ่องแท้	th @ ng^ th xx 
ถ่ายทอด	th aa j^ th @@ t^ 
ถ่ายเท	th aa j^ th ee 
ถ่ายแบบ	th aa j^ b xx p^ 
ถ้วนหน้า	th uua n^ n aa 
ถ้อย	th @ j^ 
ถ้อย	th @@ j^ 
ถ้อยคำ	th @ j^ kh a m^ 
ถ้า	th aa 
ถ้าหากว่า	th aa h aa k^ w aa 
ทดลอง	th o t^ l @@ ng^ 
ทดสอบ	th o t^ s @@ p^ 
ทดแทน	th o t^ th xx n^ 
ทน	th o n^ 
ทนทาน	th o n^ th aa n^ 
ทบทวน	th o p^ th uua n^ 
ทบวง	th a b uua ng^ 
ทมยันตี	th o m^ m a j a n^ t ii 
ทยอย	th a j @@ j^ 
ทรง	s o ng^ 
ทรงคุณวุฒิ	s o ng^ kh u n^ n a w u t^ 
ทรงจำ	s o ng^ c a m^ 
ทรงตัว	s o ng^ t uua 
ทรมาน	th @@ r a m aa n^ 
ทรรศนะ	th a t^ s a n a 
ทระนง	th @@ r a n o ng^ 
ทรัพยากร	s a p^ ph a j aa k @@ n^ 
ทรัพย์	s a p^ 
ทรัพย์สิน	s a p^ s i n^ 
ทราบ	s aa p^ 
ทราม	s aa m^ 
ทราย	s aa j^ 
ทรุด	s u t^ 
ทฤษฎี	thr i t^ s a d ii 
ทลาย	th a l aa j^ 
ทวน	th uua n^ 
ทวารวดี	th a w aa r a w a d ii 
ทวิ	th a w i 
ทวี	th a w ii 
ทวีป	th a w ii p^ 
ทว่า	th a w aa 
ทศท.	th @@ s @@ th @@ 
ทศวรรษ	th o t^ s a w a t^ 
ทหาร	th a h aa n^ 
ทหารบก	th a h aa n^ b o k^ 
ทอง	th @@ ng^ 
ทอด	th @@ t^ 
ทอดทิ้ง	th @@ t^ th i ng^ 
ทอน	th @@ n^ 
ทอริโอ	th @@ r i z oo 
ทะนุบำรุง	th a n u b a m^ r u ng^ 
ทะลัก	th a l a k^ 
ทะลุ	th a l u 
ทะเบียน	th a b iia n^ 
ทะเยอทะยาน	th a j qq th a j aa n^ 
ทะเล	th a l ee 
ทะเลทราย	th a l ee s aa j^ 
ทะเลาะ	th a l @ 
ทักทาย	th a k^ th aa j^ 
ทักษะ	th a k^ s a 
ทันที	th a n^ th ii 
ทันสมัย	th a n^ s a m a j^ 
ทับ	th a p^ 
ทัพ	th a p^ 
ทัศนคติ	th a t^ s a n a kh a t i 
ทัศนะ	th a t^ s a n a 
ทั่ว	th uua 
ทั่วถึง	th uua th v ng^ 
ทั่วโลก	th uua l oo k^ 
ทั่วไป	th uua p a j^ 
ทั้ง	th a ng^ 
ทั้งที่	th a ng^ th ii 
ทั้งนั้น	th a ng^ n a n^ 
ทั้งนี้	th a ng^ n ii 
ทั้งปวง	th a ng^ p uua ng^ 
ทั้งมวล	th a ng^ m uua n^ 
ทั้งสิ้น	th a ng^ s i n^ 
ทั้งหมด	th a ng^ m o t^ 
ทั้งหลาย	th a ng^ l aa j^ 
ทาง	th aa ng^ 
ทางการ	th aa ng^ k aa n^ 
ทางสายกลาง	th aa ng^ s aa j^ kl aa ng^ 
ทางออก	th aa ng^ z @@ k^ 
ทางเดิน	th aa ng^ d qq n^ 
ทางเลือก	th aa ng^ l vva k^ 
ทาน	th aa n^ 
ทานากะ	th aa n aa k a 
ทายาท	th aa j aa t^ 
ทารก	th aa r o k^ 
ทารุณ	th aa r u n^ 
ทาส	th aa t^ 
ทำ	th a m^ 
ทำกิน	th a m^ k i n^ 
ทำครัว	th a m^ khr uua 
ทำงาน	th a m^ ng aa n^ 
ทำท่า	th a m^ th aa 
ทำนอง	th a m^ n @@ ng^ 
ทำนองคลองธรรม	th a m^ n @@ ng^ khl @@ ng^ th a m^ 
ทำนา	th a m^ n aa 
ทำนาย	th a m^ n aa j^ 
ทำนุ	th a m^ n u 
ทำมาหากิน	th a m^ m aa h aa k i n^ 
ทำร้าย	th a m^ r aa j^ 
ทำลาย	th a m^ l aa j^ 
ทำลายล้าง	th a m^ l aa j^ l aa ng^ 
ทำเล	th a m^ l ee 
ทำใจ	th a m^ c a j^ 
ทำให้	th a m^ h a j^ 
ทำไม	th a m^ m a j^ 
ทิศ	th i t^ 
ทิศทาง	th i t^ th aa ng^ 
ทิ้ง	th i ng^ 
ที	th ii 
ทีท่า	th ii th aa 
ทีนี้	th ii n ii 
ทีม	th ii m^ 
ทีละ	th ii l a 
ทีเดียว	th ii d iia w^ 
ที่	th ii 
ที่ชัง	th ii ch a ng^ 
ที่ดิน	th ii d i n^ 
ที่ทำการ	th ii th a m^ k aa n^ 
ที่ทำงาน	th ii th a m^ ng aa n^ 
ที่นั่น	th ii n a n^ 
ที่นี่	th ii n ii 
ที่นี้	th ii n ii 
ที่ประชุม	th ii pr a ch u m^ 
ที่ปรึกษา	th ii pr v k^ s aa 
ที่พึ่ง	th ii ph v ng^ 
ที่มั่น	th ii m a n^ 
ที่มา	th ii m aa 
ที่รัก	th ii r a k^ 
ที่สุด	th ii s u t^ 
ที่หมาย	th ii m aa j^ 
ที่อยู่	th ii j uu 
ที่แล้ว	th ii l xx w^ 
ทึ่ง	th v ng^ 
ทุก	th u k^ 
ทุกขัง	th u k^ kh a ng^ 
ทุกข์	th u k^ 
ทุกข์ร้อน	th u k^ r @@ n^ 
ทุกคน	th u k^ kh o n^ 
ทุกที	th u k^ th ii 
ทุกวัน	th u k^ w a n^ 
ทุกวันนี้	th u k^ w a n^ n ii 
ทุกสิ่ง	th u k^ s i ng^ 
ทุกอย่าง	th u k^ j aa ng^ 
ทุจริต	th u t^ c a r i t^ 
ทุจริต	th u c a r i t^ 
ทุติยภูมิ	th u t i j a ph uu m^ 
ทุน	th u n^ 
ทุนทรัพย์	th u n^ n a s a p^ 
ทุนนิยม	th u n^ n i j o m^ 
ทุนเดิม	th u n^ d qq m^ 
ทุ่ง	th u ng^ 
ทุ่ม	th u m^ 
ทุ่มเท	th u m^ th ee 
ทูต	th uu t^ 
ทูน่า	th uu n aa 
ท่วมท้น	th uua m^ th o n^ 
ท่อ	th @@ 
ท่องเที่ยว	th @ ng^ th iia w^ 
ท่องเที่ยว	th @@ ng^ th iia w^ 
ท่าทาง	th aa th aa ng^ 
ท่าที	th aa th ii 
ท่าน	th a n^ 
ท่าม	th aa m^ 
ท่ามกลาง	th aa m^ kl aa ng^ 
ท่าเรือ	th aa r vva 
ท้วงติง	th uua ng^ t i ng^ 
ท้อง	th @@ ng^ 
ท้องถิ่น	th @@ ng^ th i n^ 
ท้องที่	th @@ ng^ th ii 
ท้องเรื่อง	th @@ ng^ r vva ng^ 
ท้อถอย	th @@ th @ j^ 
ท้าทาย	th aa th aa j^ 
ท้าย	th aa j^ 
ท้าว	th aa w^ 
ธนบัตร	th a n a b a t^ 
ธนาคาร	th a n aa kh aa n^ 
ธรรม	th a m^ 
ธรรมชาติ	th a m^ m a ch aa t^ 
ธรรมดา	th a m^ m a d aa 
ธรรมนูญ	th a m^ m a n uu n^ 
ธรรมราชา	th a m^ m a r aa ch aa 
ธรรมราชาลิไท	th a m^ m a r aa ch aa l i th a j^ 
ธรรมศาสตร์	th a m^ m a s aa t^ 
ธรรมะ	th a m^ m a 
ธรรมเนียม	th a m^ n iia m^ 
ธวาณัติก์	th a w aa n a t^ 
ธัญญาหาร	th a n^ j aa h aa n^ 
ธันวาคม	th a n^ w aa kh o m^ 
ธาตุ	th aa t^ 
ธาร	th aa n^ 
ธิดา	th i d aa 
ธีระสวัสดิ์	th ii r a s a w a t^ 
ธุรกิจ	th u r a k i t^ 
ธุระ	th u r a 
ธุลี	th u l ii 
ธูป	th uu p^ 
น.	n @@ 
นก	n o k^ 
นคร	n a kh @@ n^ 
นครนายก	n a kh @@ n^ n aa j o k^ 
นครบาล	n a kh @@ n^ b aa n^ 
นครศรีธรรมราช	n a kh @@ n^ s ii th a m^ m a r aa t^ 
นม	n o m^ 
นมนาน	n o m^ n aa n^ 
นริศรา	n a r i t^ s a r aa 
นริศรานุวัดติวงศ์	n a r i t^ s a r aa n u w a t^ t i w o ng^ 
นวนิยาย	n a w a n i j aa j^ 
นอ	n @@ 
นอก	n @@ k^ 
นอกจาก	n @@ k^ c aa k^ 
นอกจากนั้น	n @@ k^ c aa k^ n a n^ 
นอกจากนี้	n @@ k^ c aa k^ n ii 
นอกทาง	n @@ k^ th aa ng^ 
นอกลู่	n @@ k^ l uu 
นอกเหนือ	n @@ k^ n vva 
นองเลือด	n @@ ng^ l vva t^ 
นอน	n @@ n^ 
นอนหลับ	n @@ n^ l a p^ 
นอบน้อม	n @@ p^ n @@ m^ 
นะ	n a 
นัก	n a k^ 
นักการเมือง	n a k^ k aa n^ m vva ng^ 
นักจิตวิทยา	n a k^ c i t^ t a w i t^ th a j aa 
นักดนตรี	n a k^ d o n^ tr ii 
นักท่องเที่ยว	n a k^ th @ ng^ th iia w^ 
นักธรรม	n a k^ th a m^ 
นักธุรกิจ	n a k^ th u r a k i t^ 
นักบิน	n a k^ b i n^ 
นักปราชญ์	n a k^ pr aa t^ 
นักมวย	n a k^ m uua j^ 
นักมานุษยวิทยา	n a k^ m aa n u t^ s a j a w i t^ th a j aa 
นักรบ	n a k^ r o p^ 
นักร้อง	n a k^ r @@ ng^ 
นักลงทุน	n a k^ l o ng^ th u n^ 
นักวิจัย	n a k^ w i c a j^ 
นักวิจารณ์	n a k^ w i c aa n^ 
นักวิชาการ	n a k^ w i ch aa k aa n^ 
นักวิทยาศาสตร์	n a k^ w i t^ th a j aa s aa t^ 
นักศึกษา	n a k^ s v k^ s aa 
นักหนา	n a k^ n aa 
นักอ่าน	n a k^ z aa n^ 
นักเขียน	n a k^ kh iia n^ 
นักเรียน	n a k^ r iia n^ 
นักโทษ	n a k^ th oo t^ 
นัด	n a t^ 
นัดหมาย	n a t^ m aa j^ 
นับ	n a p^ 
นับถือ	n a p^ th vv 
นับแต่	n a p^ t xx 
นัย	n a j^ 
นัย	n a j^ j a 
นัยสำคัญ	n a j^ j a s a m^ kh a n^ 
นั่ง	n a ng^ 
นั่น	n a n^ 
นั่นเอง	n a n^ z ee ng^ 
นั้น	n a n^ 
นา	n aa 
นาค	n aa k^ 
นาง	n aa ng^ 
นางเอก	n aa ng^ z ee k^ 
นาจิบุลลาห์	n aa c i b u n^ l aa 
นาฏศิลป์	n aa t^ t a s i n^ 
นาที	n aa th ii 
นาน	n aa n^ 
นานา	n aa n aa 
นานาชาติ	n aa n aa ch aa t^ 
นาปรัง	n aa pr a ng^ 
นาม	n aa m^ 
นามธรรม	n aa m^ m a th a m^ 
นาย	n aa j^ 
นายก	n aa j o k^ 
นายกรัฐมนตรี	n aa j o k^ r a t^ th a m o n^ tr ii 
นายจ้าง	n aa j^ c aa ng^ 
นายทหาร	n aa j^ th a h aa n^ 
นายทุน	n aa j^ th u n^ 
นายพล	n aa j^ ph o n^ 
นายร้อย	n aa j^ r @@ j^ 
นายแพทย์	n aa j^ ph xx t^ 
นำ	n a m^ 
นำทาง	n a m^ th aa ng^ 
นำมา	n a m^ m aa 
นำเข้า	n a m^ kh a w^ 
นำเสนอ	n a m^ s a n qq 
นิกร	n i k @@ n^ 
นิกสัน	n i k^ s a n^ 
นิกส์	n i k^ 
นิคม	n i kh o m^ 
นิด	n i t^ 
นิดหน่อย	n i t^ n @ j^ 
นิดเดียว	n i t^ d iia w^ 
นิติบัญญัติ	n i t i b a n^ j a t^ 
นิติภาวะ	n i t i ph aa w a 
นิติศาสตร์	n i t^ t i s aa t^ 
นิทรรศการ	n i th a t^ s a k aa n^ 
นิทาน	n i th aa n^ 
นิธิ	n i th i 
นิพนธ์	n i ph o n^ 
นิพพาน	n i p^ ph aa n^ 
นิมนต์	n i m o n^ 
นิมิตหมาย	n i m i t^ m aa j^ 
นิยม	n i j o m^ 
นิยาม	n i j aa m^ 
นิยาย	n i j aa j^ 
นิรันดร์	n i r a n^ 
นิรันศักดิ์	n i r a n^ s a k^ 
นิราศ	n i r aa t^ 
นิวยอร์ค	n i w^ j @@ k^ 
นิวเคลียร์	n i w^ khl iia 
นิสัย	n i s a j^ 
นิสิต	n i s i t^ 
นิเวศวิทยา	n i w ee t^ w i t^ th a j aa 
นิ่ง	n i ng^ 
นี่	n ii 
นี่เอง	n ii z ee ng^ 
นี่แหละ	n ii l x 
นี้	n ii 
นึก	n v k^ 
นึกคิด	n v k^ kh i t^ 
นึกถึง	n v k^ th v ng^ 
นุกูล	n u k uu n^ 
นุวัดติวงศ์	n u w a t^ t i w o ng^ 
นุ่ง	n u ng^ 
นุ่มนวล	n u m^ n uua n^ 
นุ่มนิ่ม	n u m^ n i m^ 
นเรศวร	n a r ee s uua n^ 
นโยบาย	n a j oo b aa j^ 
น่ะ	n a 
น่า	n aa 
น่ากลัว	n aa kl uua 
น่าคิด	n aa kh i t^ 
น่าจะ	n aa c a 
น่าดู	n aa d uu 
น่าฟัง	n aa f a ng^ 
น่ารัก	n aa r a k^ 
น้อง	n @@ ng^ 
น้อม	n @@ m^ 
น้อย	n @@ j^ 
น้อยเนื้อต่ำใจ	n @@ j^ n vva t a m^ c a j^ 
น้า	n aa 
น้ำ	n aa m^ 
น้ำกาม	n aa m^ k aa m^ 
น้ำดื่ม	n aa m^ d vv m^ 
น้ำตาล	n aa m^ t aa n^ 
น้ำมัน	n a m^ m a n^ 
น้ำมัน	n aa m^ m a n^ 
น้ำมันดิบ	n aa m^ m a n^ d i p^ 
น้ำลาย	n aa m^ l aa j^ 
น้ำหนัก	n a m^ n a k^ 
น้ำหนึ่ง	n aa m^ n v ng^ 
น้ำเสีย	n aa m^ s iia 
น้ำเสียง	n aa m^ s iia ng^ 
น้ำใจ	n aa m^ c a j^ 
บก	b o k^ 
บก.	b @@ k @@ 
บกพร่อง	b o k^ phr @ ng^ 
บกพร่อง	b o k^ phr @@ ng^ 
บงการ	b o ng^ k aa n^ 
บท	b o t^ 
บทความ	b o t^ khw aa m^ 
บทบัญญัติ	b o t^ b a n^ j a t^ 
บทบาท	b o t^ b aa t^ 
บทเรียน	b o t^ r iia n^ 
บน	b o n^ 
บรมครู	b @@ r o m^ m a khr uu 
บรมวงศ์เธอ	b @@ r o m^ m a w o ng^ th qq 
บรรจบ	b a n^ c o p^ 
บรรจุ	b a n^ c u 
บรรดา	b a n^ d aa 
บรรทัด	b a n^ th a t^ 
บรรพชน	b a n^ ph a ch o n^ 
บรรพบุรุษ	b a n^ ph a b u r u t^ 
บรรยากาศ	b a n^ j aa k aa t^ 
บรรยาย	b a n^ j aa j^ 
บรรลุ	b a n^ l u 
บรรษัท	b a n^ s a t^ 
บรรเทา	b a n^ th a w^ 
บรรเลง	b a n^ l ee ng^ 
บริการ	b @@ r i k aa n^ 
บริจาค	b @@ r i c aa k^ 
บริบท	b @@ r i b o t^ 
บริบูรณ์	b @@ r i b uu n^ 
บริวาร	b @@ r i w aa n^ 
บริษัท	b @@ r i s a t^ 
บริสุทธิ์	b @@ r i s u t^ 
บริหาร	b @@ r i h aa n^ 
บริหาร	b @@ r i h aa n^ 
บริเวณ	b @@ r i w ee n^ 
บริโภค	b @@ r i ph oo k^ 
บริโภค	b @@ r i ph oo k^ 
บล็อค	bl @ k^ 
บวก	b uua k^ 
บวช	b uua t^ 
บวรนิเวศน์	b @@ w @@ n^ n i w ee t^ 
บวรศักดิ์	b a w @@ n^ s a k^ 
บอก	b @@ k^ 
บอกเล่า	b @@ k^ l a w^ 
บอกใบ้	b @@ k^ b a j^ 
บอด	b @@ t^ 
บอริส	b @@ r i s^ 
บอริส	b @@ r i t^ 
บัคเตรี	b a k^ t ee r ii 
บังคับ	b a ng^ kh a p^ 
บังคับการ	b a ng^ kh a p^ k aa n^ 
บังคับบัญชา	b a ng^ kh a p^ b a n^ ch aa 
บังอาจ	b a ng^ z aa t^ 
บังเกิด	b a ng^ k qq t^ 
บังเอิญ	b a ng^ z qq n^ 
บัญชร	b a n^ ch @@ n^ 
บัญชาการ	b a n^ ch aa k aa n^ 
บัญชี	b a n^ ch ii 
บัญชีเดินสะพัด	b a n^ ch ii d qq n^ s a ph a t^ 
บัญญัติ	b a n^ j a t^ 
บัญญัติ	b a n^ j a t^ 
บัณฑิต	b a n^ d i t^ 
บัดนั้น	b a t^ n a n^ 
บัดนี้	b a t^ n ii 
บัตร	b a t^ 
บันดาล	b a n^ d aa n^ 
บันทึก	b a n^ th v k^ 
บันเทิง	b a n^ th qq ng^ 
บันได	b a n^ d a j^ 
บัว	b uua 
บัวหลวง	b uua l uua ng^ 
บั้นปลาย	b a n^ pl aa j^ 
บาง	b aa ng^ 
บางที	b aa ng^ th ii 
บาดเจ็บ	b aa t^ c e p^ 
บาท	b aa t^ 
บาป	b aa p^ 
บารมี	b aa r a m ii 
บาลี	b aa l ii 
บาหลี	b aa l ii 
บำบัด	b a m^ b a t^ 
บำรุง	b a m^ r u ng^ 
บำเพ็ญ	b a m^ ph e n^ 
บำเหน็จ	b a m^ n e t^ 
บิณฑบาต	b i n^ th a b aa t^ 
บิดา	b i d aa 
บิดเบือน	b i t^ b vva n^ 
บิน	b i n^ 
บีบ	b ii p^ 
บีบคั้น	b ii p^ kh a n^ 
บีบบังคับ	b ii p^ b a ng^ kh a p^ 
บึง	b v ng^ 
บุก	b u k^ 
บุกรุก	b u k^ r u k^ 
บุกเบิก	b u k^ b qq k^ 
บุคคล	b u k^ kh o n^ 
บุคลากร	b u k^ kh a l aa k @@ n^ 
บุคลิก	b u k^ kh a l i k^ 
บุคลิกภาพ	b u k^ kh a l i k^ k a ph aa p^ 
บุคลิกลักษณะ	b u k^ kh a l i k^ l a k^ s a n a 
บุช	b u ch^ 
บุญ	b u n^ 
บุญชู	b u n^ ch uu 
บุตร	b u t^ 
บุตรศรี	b u t^ s ii 
บุพกาล	b u p^ ph a k aa n^ 
บุรุษ	b u r u t^ 
บุหรี่	b u r ii 
บูชา	b uu ch aa 
บูรณปกรณ์	b uu r a n a p a k @@ n^ 
บูรณภาพ	b uu r a n a ph aa p^ 
บูรณะ	b uu r a n a 
บูรณาการ	b uu r a n aa k aa n^ 
บ่	b @@ 
บ่ง	b o ng^ 
บ่งชี้	b o ng^ ch ii 
บ่งถึง	b o ng^ th v ng^ 
บ่งบอก	b o ng^ b @@ k^ 
บ่น	b o n^ 
บ่นว่า	b o n^ w aa 
บ่อ	b @@ 
บ่อย	b @@ j^ 
บ่อยครั้ง	b @@ j^ khr a ng^ 
บ่อเกิด	b @@ k qq t^ 
บ่าย	b aa j^ 
บ้า	b aa 
บ้าง	b aa ng^ 
บ้าน	b aa n^ 
บ้านเชียง	b aa n^ ch iia ng^ 
บ้านเมือง	b aa n^ m vva ng^ 
ป.	p @@ 
ปก	p o k^ 
ปกครอง	p o k^ khr @@ ng^ 
ปกติ	p a k a t i 
ปกติ	p o k^ k a t i 
ปกป้อง	p o k^ p @ ng^ 
ปฏิกิริยา	p a t i k i r i j aa 
ปฏิชีวนะ	p a t i ch ii w a n a 
ปฏิญาณ	p a t i j aa n^ 
ปฏิทิน	p a t i th i n^ 
ปฏิบัติ	p a t i b a t^ 
ปฏิบัติการ	p a t i b a t^ k aa n^ 
ปฏิบัติงาน	p a t i b a t^ ng aa n^ 
ปฏิบัติธรรม	p a t i b a t^ th a m^ 
ปฏิปักษ์	p a t i p a k^ 
ปฏิรูป	p a t i r uu p^ 
ปฏิวัติ	p a t i w a t^ 
ปฏิสัมพันธ์	p a t i s a m^ ph a n^ 
ปฏิเสธ	p a t i s ee t^ 
ปฐมภูมิ	p a th o m^ ph uu m^ 
ปน	p o n^ 
ปมด้อย	p o m^ d @ j^ 
ปรก	pr o k^ 
ปรกติ	pr o k^ k a t i 
ปรปักษ์	p @@ r a p a k^ 
ปรมาจารย์	p @@ r a m aa c aa n^ 
ปรองดอง	pr @@ ng^ d @@ ng^ 
ประกอบ	pr a k @@ p^ 
ประกอบการ	pr a k @@ p^ k aa n^ 
ประกัน	pr a k a n^ 
ประการ	pr a k aa n^ 
ประกาศ	pr a k aa t^ 
ประคับประคอง	pr a kh a p^ pr a kh @@ ng^ 
ประจวบเหมาะ	pr a c uua p^ m @ 
ประจักษ์	pr a c a k^ 
ประจักษ์แจ้ง	pr a c a k^ c xx ng^ 
ประจำ	pr a c a m^ 
ประจำการ	pr a c a m^ k aa n^ 
ประจำตัว	pr a c a m^ t uua 
ประจำปี	pr a c a m^ p ii 
ประจำวัน	pr a c a m^ w a n^ 
ประชวร	pr a ch uua n^ 
ประชา	pr a ch aa 
ประชากร	pr a ch aa k @@ n^ 
ประชาคม	pr a ch aa kh o m^ 
ประชาชน	pr a ch aa ch o n^ 
ประชาชาติ	pr a ch aa ch aa t^ 
ประชาธิปัตย์	pr a ch aa th i p a t^ 
ประชาธิปไตย	pr a ch aa th i p^ p a t a j^ 
ประชาราษฎร์	pr a ch aa r aa t^ 
ประชาสัมพันธ์	pr a ch aa s a m^ ph a n^ 
ประชุม	pr a ch u m^ 
ประณาม	pr a n aa m^ 
ประณีต	pr a n ii t^ 
ประดับ	pr a d a p^ 
ประดิษฐ์	pr a d i t^ 
ประติมากร	pr a t i m aa k @@ n^ 
ประติมากรรม	pr a t i m aa k a m^ 
ประตู	pr a t uu 
ประถม	pr a th o m^ 
ประถมศึกษา	pr a th o m^ s v k^ s aa 
ประทับ	pr a th a p^ 
ประทับใจ	pr a th a p^ c a j^ 
ประทาน	pr a th aa n^ 
ประทุษร้าย	pr a th u t^ s a r aa j^ 
ประท้วง	pr a th uua ng^ 
ประธาน	pr a th aa n^ 
ประธานาธิบดี	pr a th aa n aa th i p^ b @@ d ii 
ประธานาธิบดี	pr a th aa n aa th i p^ b @@0 d ii 
ประธานาธิบดี	pr a th aa n aa th i b @@ d ii 
ประนีประนอม	pr a n ii pr a n @@ m^ 
ประปา	pr a p aa 
ประพฤติ	pr a phr v t^ 
ประพันธ์	pr a ph a n^ 
ประพาส	pr a ph aa t^ 
ประมง	pr a m o ng^ 
ประมวล	pr a m uua n^ 
ประมวลผล	pr a m uua n^ ph o n^ 
ประมาณ	pr a m aa n^ 
ประมาท	pr a m aa t^ 
ประมุข	pr a m u k^ 
ประมุข	pr a m u k^ 
ประมูล	pr a m uu n^ 
ประยุกต์	pr a j u k^ 
ประยุกต์	pr a j u k^ 
ประวัติ	pr a w a t^ 
ประวัติการณ์	pr a w a t^ k aa n^ 
ประวัติศาสตร์	pr a w a t^ s aa t^ 
ประสงค์	pr a s o ng^ 
ประสบ	pr a s o p^ 
ประสบการณ์	pr a s o p^ k aa n^ 
ประสม	pr a s o m^ 
ประสาท	pr a s aa t^ 
ประสาน	pr a s aa n^ 
ประสิทธิผล	pr a s i t^ th i ph o n^ 
ประสิทธิภาพ	pr a s i t^ th i ph aa p^ 
ประหยัด	pr a j a t^ 
ประหลาด	pr a l aa t^ 
ประหัตประหาร	pr a h a t^ pr a h aa n^ 
ประเด็น	pr a d e n^ 
ประเทศ	pr a th ee t^ 
ประเทศราช	pr a th ee t^ s a r aa t^ 
ประเพณี	pr a ph ee n ii 
ประเภท	pr a ph ee t^ 
ประเมิน	pr a m qq n^ 
ประเสริฐ	pr a s qq t^ 
ประโยค	pr a j oo k^ 
ประโยชน์	pr a j oo t^ 
ปรัชญา	pr a t^ j aa 
ปรับ	pr a p^ 
ปรับปรุง	pr a p^ pr u ng^ 
ปรากฏ	pr aa k o t^ 
ปรากฏการณ์	pr aa k o t^ t a k aa n^ 
ปรากฏการณ์	pr aa k o t^ t a k aa n^ 
ปราจีนบุรี	pr aa c ii n^ b u r ii 
ปราบ	pr aa p^ 
ปราบปราม	pr aa p^ pr aa m^ 
ปรารถนา	pr aa t^ th a n aa 
ปราศจาก	pr aa t^ s a c aa k^ 
ปราศรัย	pr aa s a j^ 
ปราสาท	pr aa s aa t^ 
ปราโมช	pr aa m oo t^ 
ปราโมทย์	pr aa m oo t^ 
ปริจเฉท	p a r i t^ ch ee t^ 
ปริญญา	p a r i n^ j aa 
ปริญญาตรี	p a r i n^ j aa tr ii 
ปริตตา	p a r i t^ t aa 
ปริมณฑล	p a r i m o n^ th o n^ 
ปริมาณ	p a r i m aa n^ 
ปริยาย	p a r i j aa j^ 
ปรีชา	pr ii ch aa 
ปรีดา	pr ii d aa 
ปรึกษา	pr v k^ s aa 
ปรุงแต่ง	pr u ng^ t x ng^ 
ปลด	pl o t^ 
ปลดเปลื้อง	pl o t^ pl vva ng^ 
ปลอด	pl @@ t^ 
ปลอดภัย	pl @@ t^ ph a j^ 
ปลอม	pl @@ m^ 
ปลัด	p a l a t^ 
ปลา	pl aa 
ปลาย	pl aa j^ 
ปลุก	pl u k^ 
ปลูก	pl uu k^ 
ปลูกฝัง	pl uu k^ f a ng^ 
ปล่อย	pl @ j^ 
ปล่อยตัว	pl @ j^ t uua 
ปวงชน	p uua ng^ ch o n^ 
ปวด	p uua t^ 
ปะปน	p a p o n^ 
ปะลิศ	p a l i t^ 
ปัจจัย	p a t^ c a j^ 
ปัจจุบัน	p a t^ c u b a n^ 
ปัจจุบันนี้	p a t^ c u b a n^ n ii 
ปัจเจกชน	p a t^ c ee k^ ch o n^ 
ปัญญา	p a n^ j aa 
ปัญญาชน	p a n^ j aa ch o n^ 
ปัญญาอ่อน	p a n^ j aa z @@ n^ 
ปัญหา	p a n^ h aa 
ปัดเป่า	p a t^ p a w^ 
ปัน	p a n^ 
ปันผล	p a n^ ph o n^ 
ปันยารชุน	p a n^ j aa r a ch u n^ 
ปั่นป่วน	p a n^ p uua n^ 
ปั้น	p a n^ 
ปาก	p aa k^ 
ปากท้อง	p aa k^ th @@ ng^ 
ปานกลาง	p aa n^ kl aa ng^ 
ปารุสกวัน	p aa r u t^ s a k a w a n^ 
ปาสคาล	p aa s^ kh aa l^ 
ปิด	p i t^ 
ปิดกั้น	p i t^ k a n^ 
ปิดบัง	p i t^ b a ng^ 
ปี	p ii 
ปีก	p ii k^ 
ปีติ	p ii t i 
ปีเตอร์ลินช์	p ii t qq l i n^ 
ปี่	p ii 
ปึกแผ่น	p v k^ ph x n^ 
ปืน	p vv n^ 
ปืนกล	p vv n^ k o n^ 
ปุถุชน	p u th u ch o n^ 
ปุ่ม	p u m^ 
ปุ๋ย	p u j^ 
ปู	p uu 
ปู่	p uu 
ป่น	p o n^ 
ป่วน	p uua n^ 
ป่วย	p uua j^ 
ป่า	p aa 
ป่าช้า	p aa ch aa 
ป่านนี้	p aa n^ n ii 
ป่าสงวน	p aa s a ng uua n^ 
ป่าไม้	p aa m a j^ 
ป่าไม้	p aa m aa j^ 
ป้องกัน	p @ ng^ k a n^ 
ป้อน	p @@ n^ 
ป้อม	p @ m^ 
ป้าย	p aa j^ 
ป๋วย	p uua j^ 
ผกผัน	ph o k^ ph a n^ 
ผจญภัย	ph a c o n^ ph a j^ 
ผนวก	ph a n uua k^ 
ผนึก	ph a n v k^ 
ผม	ph o m^ 
ผล	ph o n^ 
ผลกรรม	ph o n^ k a m^ 
ผลกระทบ	ph o n^ kr a th o p^ 
ผลงาน	ph o n^ ng aa n^ 
ผลดี	ph o n^ d ii 
ผลประโยชน์	ph o n^ pr a j oo t^ 
ผลผลิต	ph o n^ ph a l i t^ 
ผลลัพธ์	ph o n^ l a p^ 
ผลัก	phl a k^ 
ผลักดัน	phl a k^ d a n^ 
ผลัดเปลี่ยน	phl a t^ pl iia n^ 
ผลิต	ph a l i t^ 
ผลิตผล	ph a l i t^ t a ph o n^ 
ผลิตภัณฑ์	ph a l i t^ t a ph a n^ 
ผลเสีย	ph o n^ s iia 
ผลไม้	ph o n^ l a m aa j^ 
ผสม	ph a s o m^ 
ผสมผสาน	ph a s o m^ ph a s aa n^ 
ผัง	ph a ng^ 
ผังเมือง	ph a ng^ m vva ng^ 
ผัน	ph a n^ 
ผันผวน	ph a n^ ph uua n^ 
ผันแปร	ph a n^ pr xx 
ผัว	ph uua 
ผาสุก	ph aa s u k^ 
ผิด	ph i t^ 
ผิดปกติ	ph i t^ p o k^ k a t i 
ผิดพลาด	ph i t^ phl aa t^ 
ผิดหวัง	ph i t^ w a ng^ 
ผิดแผก	ph i t^ ph xx k^ 
ผิน	ph i n^ 
ผิว	ph i w^ 
ผิวหนัง	ph i w^ n a ng^ 
ผี	ph ii 
ผีสาง	ph ii s aa ng^ 
ผึ้ง	ph v ng^ 
ผืน	ph vv n^ 
ผืนผ้า	ph vv n^ ph aa 
ผุด	ph u t^ 
ผูกขาด	ph uu k^ kh aa t^ 
ผูกพัน	ph uu k^ ph a n^ 
ผู้	ph uu 
ผู้ก่อการ	ph uu k @@ k aa n^ 
ผู้คน	ph uu kh o n^ 
ผู้ชาย	ph uu ch aa j^ 
ผู้ช่วย	ph uu ch uua j^ 
ผู้นำ	ph uu n a m^ 
ผู้น้อย	ph uu n @@ j^ 
ผู้บริหาร	ph uu b @@ r i h aa n^ 
ผู้บริโภค	ph uu b @@ r i ph oo k^ 
ผู้บังคับบัญชา	ph uu b a ng^ kh a p^ b a n^ ch aa 
ผู้บัญชาการ	ph uu b a n^ ch aa k aa n^ 
ผู้ปฏิบัติงาน	ph uu p a t i b a t^ ng aa n^ 
ผู้ปฏิวัติ	ph uu p a t i w a t^ 
ผู้ประกอบการ	ph uu pr a k @@ p^ k aa n^ 
ผู้ป่วย	ph uu p uua j^ 
ผู้ผลิต	ph uu ph a l i t^ 
ผู้พิพากษา	ph uu ph i ph aa k^ s aa 
ผู้ฟัง	ph uu f a ng^ 
ผู้มีอิทธิพล	ph uu m ii z i t^ th i ph o n^ 
ผู้รับผิดชอบ	ph uu r a p^ ph i t^ ch @@ p^ 
ผู้รู้	ph uu r uu 
ผู้ร้าย	ph uu r aa j^ 
ผู้ว่า	ph uu w aa 
ผู้ว่าการ	ph uu w aa k aa n^ 
ผู้ว่าราชการ	ph uu w aa r aa t^ ch a k aa n^ 
ผู้สนับสนุน	ph uu s a n a p^ s a n u n^ 
ผู้สมัคร	ph uu s a m a k^ 
ผู้สร้าง	ph uu s aa ng^ 
ผู้สอน	ph uu s @@ n^ 
ผู้สื่อข่าว	ph uu s vv kh aa w^ 
ผู้หญิง	ph uu j i ng^ 
ผู้อำนวยการ	ph uu z a m^ n uua j^ k aa n^ 
ผู้อื่น	ph uu z vv n^ 
ผู้อ่าน	ph uu z aa n^ 
ผู้เขียน	ph uu kh iia n^ 
ผู้เข้าร่วม	ph uu kh a w^ r uua m^ 
ผู้เช่า	ph uu ch a w^ 
ผู้เรียน	ph uu r iia n^ 
ผู้แทน	ph uu th xx n^ 
ผู้โดยสาร	ph uu d oo j^ s aa n^ 
ผู้ใช้	ph uu ch a j^ 
ผู้ใช้แรงงาน	ph uu ch a j^ r xx ng^ ng aa n^ 
ผู้ใด	ph uu d a j^ 
ผู้ใหญ่	ph uu j a j^ 
ผู้ให้	ph uu h a j^ 
ผ่อน	ph @@ n^ 
ผ่อนคลาย	ph @ n^ khl aa j^ 
ผ่อนปรน	ph @ n^ pr o n^ 
ผ่าตัด	ph aa t a t^ 
ผ่าน	ph aa n^ 
ผ้า	ph aa 
ฝน	f o n^ 
ฝรั่งเศส	f a r a ng^ s ee t^ 
ฝักใฝ่	f a k^ f a j^ 
ฝัง	f a ng^ 
ฝัน	f a n^ 
ฝันเฟื่อง	f a n^ f vva ng^ 
ฝั่ง	f a ng^ 
ฝา	f aa 
ฝาก	f aa k^ 
ฝาผนัง	f aa ph a n a ng^ 
ฝิ่น	f i n^ 
ฝีมือ	f ii m vv 
ฝึก	f v k^ 
ฝึกฝน	f v k^ f o n^ 
ฝึกอบรม	f v k^ z o p^ r o m^ 
ฝืดเคือง	f vv t^ kh vva ng^ 
ฝุ่น	f u n^ 
ฝ่า	f aa 
ฝ่าฝืน	f aa f vv n^ 
ฝ่าย	f aa j^ 
ฝ่ายค้าน	f aa j^ kh aa n^ 
พ.ร.บ.	ph @@ r @@ b @@ 
พงศาวดาร	ph o ng^ s aa w a d aa n^ 
พงษ์พานิช	ph o ng^ ph aa n i t^ 
พจนา	ph o t^ c a n aa 
พนักงาน	ph a n a k^ ng aa n^ 
พบ	ph o p^ 
พบปะ	ph o p^ p a 
พยัญชนะ	ph a j a n^ ch a n a 
พยากรณ์	ph a j aa k @@ n^ 
พยาธิ	ph a j aa t^ 
พยาบาล	ph a j aa b aa n^ 
พยายาม	ph a j aa j aa m^ 
พยุง	ph a j u ng^ 
พรมแดน	phr o m^ d xx n^ 
พรรค	ph a k^ 
พรรคพวก	ph a k^ ph uua k^ 
พรรณนา	ph a n^ n a n aa 
พรสวรรค์	ph @@ n^ s a w a n^ 
พรหมสูตร	phr o m^ m a s uu t^ 
พระ	phr a 
พระจันทร์	phr a c a n^ 
พระจุลจอมเกล้า	phr a c u n^ l a c @@ m^ kl aa w^ 
พระที่นั่ง	phr a th ii n a ng^ 
พระธรรมศาสตร์	phr a th a m^ m a s aa t^ 
พระบรมราชโองการ	phr a b @@ r o m^ m a r aa t^ ch a z oo ng^ k aa n^ 
พระบรมรูป	phr a b @@ r o m^ m a r uu p^ 
พระบาท	phr a b aa t^ 
พระบาทสมเด็จ	phr a b aa t^ s o m^ d e t^ 
พระผู้มีพระภาคเจ้า	phr a ph uu m ii phr a ph aa k^ c aa w^ 
พระพุทธรูป	phr a ph u t^ th a r uu p^ 
พระพุทธศาสนา	phr a ph u t^ th a s aa t^ s a n aa 
พระพุทธองค์	phr a ph u t^ th a z o ng^ 
พระพุทธเจ้า	phr a ph u t^ th a c a w^ 
พระพุทธเจ้า	phr a ph u t^ th a c aa w^ 
พระภิกษุ	phr a ph i k^ s u 
พระมหากษัตริย์	phr a m a h aa k a s a t^ 
พระยา	phr a j aa 
พระราชดำรัส	phr a r aa t^ ch a d a m^ r a t^ 
พระราชดำริ	phr a r aa t^ ch a d a m^ r i 
พระราชทาน	phr a r aa t^ ch a th aa n^ 
พระราชบัญญัติ	phr a r aa t^ ch a b a n^ j a t^ 
พระราชพิธี	phr a r aa t^ ch a ph i th ii 
พระราชวัง	phr a r aa t^ ch a w a ng^ 
พระราชวินิจฉัย	phr a r aa t^ ch a w i n i t^ ch a j^ 
พระราชอำนาจ	phr a r aa t^ ch a z a m^ n aa t^ 
พระราชาคณะ	phr a r aa ch aa kh a n a 
พระสงฆ์	phr a s o ng^ 
พระองค์	phr a z o ng^ 
พระอาทิตย์	phr a z aa th i t^ 
พระเกียรติ	phr a k iia t^ 
พระเจ้า	phr a c a w^ 
พระเจ้า	phr a c aa w^ 
พระเจ้าอยู่หัว	phr a c aa w^ j uu h uua 
พระเชตุพน	phr a ch ee t u ph o n^ 
พระเยซู	phr a j ee s uu 
พระเยาว์	phr a j a w^ 
พระเวท	phr a w ee t^ 
พระเอก	phr a z ee k^ 
พราก	phr aa k^ 
พราหมณ์	phr aa m^ 
พริกไทย	phr i k^ th a j^ 
พร้อม	phr @@ m^ 
พร้อมกัน	phr @@ m^ k a n^ 
พร้อมกับ	phr @@ m^ k a p^ 
พร้อมทั้ง	phr @@ m^ th a ng^ 
พร้อมใจ	phr @@ m^ c a j^ 
พฤติกรรม	phr v t^ t i k a m^ 
พฤติการณ์	phr v t^ t i k aa n^ 
พฤตินัย	phr v t^ t i n a j^ 
พฤศจิกายน	phr v t^ s a c i k aa j o n^ 
พฤษภาคม	phr v t^ s a ph aa kh o m^ 
พฤหัสบดี	ph a r v h a t^ s a b @@ d ii 
พล	ph o n^ 
พลตรี	ph o n^ tr ii 
พลตำรวจ	ph o n^ t a m^ r uua t^ 
พลตำรวจเอก	ph o n^ t a m^ r uua t^ z ee k^ 
พลพรรค	ph o n^ l a ph a k^ 
พลวัตร	ph o n^ l a w a t^ 
พลสิน	ph o n^ s i n^ 
พลอย	phl @@ j^ 
พลอากาศ	ph o n^ z aa k aa t^ 
พลอากาศเอก	ph o n^ z aa k aa t^ z ee k^ 
พละ	ph a l a 
พละกำลัง	ph a l a k a m^ l a ng^ 
พลัง	ph a l a ng^ 
พลังงาน	ph a l a ng^ ng aa n^ 
พลังน้ำ	ph a l a ng^ n aa m^ 
พลัดพราก	phl a t^ phr aa k^ 
พลาง	phl aa ng^ 
พลาด	phl aa t^ 
พลานามัย	ph a l aa n aa m a j^ 
พลาสติก	phl aa s^ t i k^ 
พลิก	phl i k^ 
พลเมือง	ph o n^ l a m vva ng^ 
พลเรือน	ph o n^ l a r vva n^ 
พลเรือเอก	ph o n^ r vva z ee k^ 
พลเอก	ph o n^ z ee k^ 
พวก	ph uua k^ 
พวกเขา	ph uua k^ kh a w^ 
พวกเรา	ph uua k^ r a w^ 
พวง	ph uua ng^ 
พวน	ph uua n^ 
พอ	ph @@ 
พอควร	ph @@ kh uua n^ 
พอจะ	ph @@ c a 
พอดี	ph @@ d ii 
พอเพียง	ph @@ ph iia ng^ 
พอใจ	ph @@ c a j^ 
พะวง	ph a w o ng^ 
พัก	ph a k^ 
พักผ่อน	ph a k^ ph @ n^ 
พัง	ph a ng^ 
พังพอน	ph a ng^ ph @@ n^ 
พัฒนา	ph a t^ th a n aa 
พัฒนาการ	ph a t^ th a n aa k aa n^ 
พัด	ph a t^ 
พัน	ph a n^ 
พันธบัตร	ph a n^ th a b a t^ 
พันธมิตร	ph a n^ th a m i t^ 
พันธะ	ph a n^ th a 
พันธุกรรม	ph a n^ th u k a m^ 
พันธุวิศวกรรม	ph a n^ th u w i t^ s a w a k a m^ 
พันธุ์	p a n^ 
พันธุ์	ph a n^ 
พันเอก	ph a n^ z ee k^ 
พันโท	ph a n^ th oo 
พับ	ph a p^ 
พัวพัน	ph uua ph a n^ 
พา	ph aa 
พาณิชยกรรม	ph aa n i t^ ch a j a k a m^ 
พาณิชย์	ph aa n i t^ 
พาย	ph aa j^ 
พายุ	ph aa j u 
พาหะ	ph aa h a 
พำนัก	ph a m^ n a k^ 
พิการ	ph i k aa n^ 
พิจารณา	ph i c aa r a n aa 
พิชิต	ph i ch i t^ 
พิทักษ์	ph i th a k^ 
พิธี	ph i th ii 
พิธีกร	ph i th ii k @@ n^ 
พิธีกรรม	ph i th ii k a m^ 
พิธีการ	ph i th ii k aa n^ 
พิธีรีตอง	ph i th ii r ii t @@ ng^ 
พินิจ	ph i n i t^ 
พิบูล	ph i b uu n^ 
พิบูลสงคราม	ph i b uu n^ s o ng^ khr aa m^ 
พิพัฒน์เสรีธรรม	ph i ph a t^ s ee r ii th a m^ 
พิพากษา	ph i ph aa k^ s aa 
พิพาท	ph i ph aa t^ 
พิพิธภัณฑสถาน	ph i ph i t^ th a ph a n^ th a s a th aa n^ 
พิพิธภัณฑ์	ph i ph i t^ th a ph a n^ 
พิมพ์	ph i m^ 
พิมพ์ดีด	ph i m^ d ii t^ 
พิมพ์ใจ	ph i m^ c a j^ 
พิษ	ph i t^ 
พิษณุโลก	ph i t^ s a n u l oo k^ 
พิสดาร	ph i t^ s a d aa n^ 
พิสัย	ph i s a j^ 
พิสูจน์	ph i s uu t^ 
พิเคราะห์	ph i khr @ 
พิเศษ	ph i s ee t^ 
พี	ph ii 
พีระศรี	ph ii r a s ii 
พี่	ph ii 
พี่เลี้ยง	ph ii l iia ng^ 
พึง	ph v ng^ 
พึงประสงค์	ph v ng^ pr a s o ng^ 
พึงปรารถนา	ph v ng^ pr aa t^ th a n aa 
พึงพอใจ	ph v ng^ ph @@ c a j^ 
พึ่ง	ph v ng^ 
พึ่งพา	ph v ng^ ph aa 
พึ่งพิง	ph v ng^ ph i ng^ 
พืช	ph vv t^ 
พืชพันธุ์	ph vv t^ ph a n^ 
พื้น	ph vv n^ 
พื้นฐาน	ph vv n^ th aa n^ 
พื้นดิน	ph vv n^ d i n^ 
พื้นที่	ph vv n^ th ii 
พื้นบ้าน	ph vv n^ b aa n^ 
พื้นเพ	ph vv n^ ph ee 
พื้นเมือง	ph vv n^ m vva ng^ 
พุทธ	ph u t^ 
พุทธทาส	ph u t^ th a th aa t^ 
พุทธธรรม	ph u t^ th a th a m^ 
พุทธบริษัท	ph u t^ th a b @@ r i s a t^ 
พุทธประวัติ	ph u t^ th a pr a w a t^ 
พุทธศตวรรษ	ph u t^ th a s a t^ t a w a t^ 
พุทธศตวรรษ	ph u t^ th a s a t a w a t^ 
พุทธศักราช	ph u t^ th a s a k^ k a r aa t^ 
พุทธศาสนา	ph u t^ th a s aa t^ s a n aa 
พุธ	ph u t^ 
พุ่ง	ph u ng^ 
พุ่มข้าวบิณฑ์	ph u m^ kh aa w^ b i n^ 
พูด	ph uu t^ 
พูดคุย	ph uu t^ kh u j^ 
พูดจา	ph uu t^ c aa 
พ่วง	ph uua ng^ 
พ่อ	ph @@ 
พ่อขุน	ph @@ kh u n^ 
พ่อค้า	ph @@ kh aa 
พ่อตา	ph @@ t aa 
พ่าย	ph aa j^ 
พ่ายแพ้	ph aa j^ ph xx 
พ้น	ph o n^ 
พ้อง	ph @@ ng^ 
ฟรอยด์	fr @@ j^ 
ฟรี	fr ii 
ฟอร์แทรน	f @@ thr xx n^ 
ฟัง	f a ng^ 
ฟาก	f aa k^ 
ฟาง	f aa ng^ 
ฟาฟิลอฟ	f aa f i l @@ p^ 
ฟิลิปปินส์	f i l i p^ p i n^ 
ฟิลิปส์	f i l i p^ 
ฟื้น	f vv n^ 
ฟื้นฟู	f vv n^ f uu 
ฟุ่มเฟือย	f u m^ f vva j^ 
ฟูคูดะ	f uu kh uu d a 
ฟ้อง	f @@ ng^ 
ฟ้องร้อง	f @@ ng^ r @@ ng^ 
ฟ้า	f aa 
ฟ้าผ่า	f aa ph aa 
ภพ	ph o p^ 
ภยันตราย	ph a j a n^ t a r aa j^ 
ภรรยา	ph a n^ r a j aa 
ภริยา	ph a r i j aa 
ภักดี	ph a k^ d ii 
ภัย	ph a j^ 
ภัยพิบัติ	ph a j^ ph i b a t^ 
ภาค	ph aa k^ 
ภาคภูมิใจ	ph aa k^ ph uu m^ c a j^ 
ภาคเหนือ	ph aa k^ n vva 
ภาพ	ph aa p^ 
ภาพถ่าย	ph aa p^ th aa j^ 
ภาพพจน์	ph aa p^ ph o t^ 
ภาพยนตร์	ph aa p^ ph a j o n^ 
ภายนอก	ph aa j^ n @@ k^ 
ภายหน้า	ph aa j^ n aa 
ภายหลัง	ph aa j^ l a ng^ 
ภายใต้	ph aa j^ t aa j^ 
ภายใน	ph aa j^ n a j^ 
ภารกิจ	ph aa r a k i t^ 
ภาระ	ph aa r a 
ภาวะ	ph aa w a 
ภาษา	ph aa s aa 
ภาษาศาสตร์	ph aa s aa s aa t^ 
ภาษี	ph aa s ii 
ภิกษุ	ph i k^ s u 
ภู	ph uu 
ภูธร	ph oo th @@ n^ 
ภูธร	ph uu th @@ n^ 
ภูมิ	ph uu m^ 
ภูมิธรรม	ph uu m^ th a m^ 
ภูมิปัญญา	ph uu m^ p a n^ j aa 
ภูมิพล	ph uu m i ph o n^ 
ภูมิภาค	ph uu m^ m i ph aa k^ 
ภูมิภาค	ph uu m i ph aa k^ 
ภูมิศาสตร์	ph uu m i s aa t^ 
ภูมิหลัง	ph uu m^ l a ng^ 
ภูมิแพ้	ph uu m^ ph xx 
ภูมิใจ	ph uu m^ c a j^ 
ภูเขา	ph uu kh a w^ 
ม.	m @@ 
มกราคม	m a k a r aa kh o m^ 
มงกุฎเกล้า	m o ng^ k u t^ kl aa w^ 
มงคล	m o ng^ kh o n^ 
มณเฑียรบาล	m o n^ th iia n^ b aa n^ 
มติ	m a t i 
มนตรี	m o n^ tr ii 
มนต์ขลัง	m o n^ khl a ng^ 
มนัส	m a n a t^ 
มนุษยชน	m a n u t^ s a j a ch o n^ 
มนุษยชาติ	m a n u t^ s a j a ch aa t^ 
มนุษยสัมพันธ์	m a n u t^ s a j a s a m^ ph a n^ 
มนุษย์	m a n u t^ 
มรดก	m @@ r a d o k^ 
มรรคผล	m a k^ ph o n^ 
มลทิน	m o n^ th i n^ 
มลพิษ	m o n^ l a ph i t^ 
มลภาวะ	m o n^ l a ph aa w a 
มวล	m uua n^ 
มวลชน	m uua n^ ch o n^ 
มหัศจรรย์	m a h a t^ s a c a n^ 
มหา	m a h aa 
มหาชน	m a h aa ch o n^ 
มหาดไทย	m a h aa t^ th a j^ 
มหาประเทศ	m a h aa pr a th ee t^ 
มหายาน	m a h aa j aa n^ 
มหาราช	m a h aa r aa t^ 
มหาวิทยาลัย	m a h aa w i t^ th a j aa l a j^ 
มหาศาล	m a h aa s aa n^ 
มหาสมุทร	m a h aa s a m u t^ 
มหาอำนาจ	m a h aa z a m^ n aa t^ 
มอง	m @@ ng^ 
มองข้าม	m @@ ng^ kh aa m^ 
มองเห็น	m @@ ng^ h e n^ 
มองโกเลีย	m @ ng^ k oo l iia 
มอบ	m @@ p^ 
มอบหมาย	m @@ p^ m aa j^ 
มอร์แกน	m @@ k xx n^ 
มอเตอร์ไซค์	m @@ t qq s a j^ 
มะขาม	m a kh aa m^ 
มะเร็ง	m a r e ng^ 
มัก	m a k^ 
มักกะสัน	m a k^ k a s a n^ 
มักจะ	m a k^ c a 
มัจฉา	m a t^ ch aa 
มัธยม	m a t^ th a j o m^ 
มัน	m a n^ 
มันสมอง	m a n^ s a m @@ ng^ 
มันสำปะหลัง	m a n^ s a m^ p a l a ng^ 
มัว	m uua 
มัวหมอง	m uua m @@ ng^ 
มัวเมา	m uua m a w^ 
มั่งคั่ง	m a ng^ kh a ng^ 
มั่งมี	m a ng^ m ii 
มั่นคง	m a n^ kh o ng^ 
มั่นใจ	m a n^ c a j^ 
มั่วสุม	m uua s u m^ 
มา	m aa 
มาก	m aa k^ 
มากมาย	m aa k^ m aa j^ 
มาจาก	m aa c aa k^ 
มาตรการ	m aa t^ tr a k aa n^ 
มาตรฐาน	m aa t^ tr a th aa n^ 
มาตรา	m aa t^ tr aa 
มาตรา	m aa tr aa 
มานะ	m aa n a 
มานาน	m aa n aa n^ 
มานุษยวิทยา	m aa n u t^ s a j a w i t^ th a j aa 
มาบตาพุด	m aa p^ t aa ph u t^ 
มาฟิโอโส	m aa f i z oo s oo 
มายา	m aa j aa 
มารดา	m aa n^ d aa 
มารยาท	m aa r a j aa t^ 
มาร์กซ์	m aa k^ 
มาสโลว์	m aa s a l oo 
มาเฟีย	m aa f iia 
มาเลย์	m aa l ee 
มาเลเซีย	m aa l ee s iia 
มาแรนซาโน	m aa r xx n^ s aa n oo 
มิ	m i 
มิจฉาชีพ	m i t^ ch aa ch ii p^ 
มิฉะนั้น	m i ch a n a n^ 
มิตร	m i t^ 
มิติ	m i t i 
มิถุนายน	m i th u n aa j o n^ 
มิอาจ	m i z aa t^ 
มิเช่นนั้น	m i ch e n^ n a n^ 
มิใช่	m i ch a j^ 
มิได้	m i d aa j^ 
มี	m ii 
มีชัย	m ii ch a j^ 
มีนาคม	m ii n aa kh o m^ 
มีแต่	m ii t xx 
มึง	m v ng^ 
มืด	m vv t^ 
มือ	m vv 
มือดี	m vv d ii 
มุกดาหาร	m u k^ d aa h aa n^ 
มุม	m u m^ 
มุมานะ	m u m aa n a 
มุสลิม	m u t^ s a l i m^ 
มุ่ง	m u ng^ 
มุ่งมั่น	m u ng^ m a n^ 
มุ่งหน้า	m u ng^ n aa 
มุ่งหมาย	m u ng^ m aa j^ 
มุ่งหวัง	m u ng^ w a ng^ 
มุ่งเน้น	m u ng^ n e n^ 
มูล	m uu n^ 
มูลค่า	m uu n^ kh aa 
มูลฐาน	m uu n^ th aa n^ 
มูลเหตุ	m uu n^ h ee t^ 
มโหฬาร	m a h oo l aa n^ 
ม้า	m aa 
ยก	j o k^ 
ยกย่อง	j o k^ j @ ng^ 
ยกย่อง	j o k^ j @@ ng^ 
ยกเลิก	j o k^ l qq k^ 
ยกเว้น	j o k^ w e n^ 
ยงค์	j o ng^ 
ยงใจยุทธ	j o ng^ c a j^ j u t^ 
ยถากรรม	j a th aa k a m^ 
ยศ	j o t^ 
ยอก	j @@ k^ 
ยอด	j @@ t^ 
ยอดเยี่ยม	j @@ t^ j iia m^ 
ยอม	j @@ m^ 
ยอมรับ	j @@ m^ r a p^ 
ยัง	j a ng^ 
ยังคง	j a ng^ kh o ng^ 
ยังชีพ	j a ng^ ch ii p^ 
ยังเติร์ก	j a ng^ t qq k^ 
ยังไง	j a ng^ ng a j^ 
ยัดเยียด	j a t^ j iia t^ 
ยับยั้ง	j a p^ j a ng^ 
ยับเยิน	j a p^ j qq n^ 
ยั่งยืน	j a ng^ j vv n^ 
ยั่วยุ	j uua j u 
ยั้งคิด	j a ng^ kh i t^ 
ยา	j aa 
ยาก	j aa k^ 
ยากจน	j aa k^ c o n^ 
ยากลำบาก	j aa k^ l a m^ b aa k^ 
ยากเย็น	j aa k^ j e n^ 
ยากแค้น	j aa k^ kh xx n^ 
ยากไร้	j aa k^ r a j^ 
ยางพารา	j aa ng^ ph aa r aa 
ยาม	j aa m^ 
ยาย	j aa j^ 
ยาว	j aa w^ 
ยาวนาน	j aa w^ n aa n^ 
ยาวเหยียด	j aa w^ j iia t^ 
ยาเสพติด	j aa s ee p^ t i t^ 
ยำเกรง	j a m^ kr ee ng^ 
ยิง	j i ng^ 
ยิน	j i n^ 
ยินดี	j i n^ d ii 
ยินยอม	j i n^ j @@ m^ 
ยิว	j i w^ 
ยิ่ง	j i ng^ 
ยิ่งกว่า	j i ng^ kw aa 
ยิ่งกว่านั้น	j i ng^ kw aa n a n^ 
ยิ่งยวด	j i ng^ j uua t^ 
ยิ่งหย่อน	j i ng^ j @ n^ 
ยิ่งใหญ่	j i ng^ j a j^ 
ยี่	j ii 
ยี่สิบ	j ii s i p^ 
ยึด	j v t^ 
ยึดครอง	j v t^ khr @@ ng^ 
ยึดถือ	j v t^ th vv 
ยึดมั่น	j v t^ m a n^ 
ยึดเหนี่ยว	j v t^ n iia w^ 
ยืด	j vv t^ 
ยืดหยุ่น	j vv t^ j u n^ 
ยืดเยื้อ	j vv t^ j vva 
ยืน	j vv n^ 
ยืนกราน	j vv n^ kr aa n^ 
ยืนต้น	j vv n^ t o n^ 
ยืนยัน	j vv n^ j a n^ 
ยืนยาว	j vv n^ j aa w^ 
ยืม	j vv m^ 
ยื่น	j vv n^ 
ยุค	j u k^ 
ยุติ	j u t^ 
ยุติ	j u t^ t i 
ยุติ	j u t i 
ยุติธรรม	j u t^ t i th a m^ 
ยุทธการ	j u t^ th a k aa n^ 
ยุทธศาสตร์	j u t^ th a s aa t^ 
ยุบ	j u p^ 
ยุโรป	j u r oo p^ 
ยุ่ง	j u ng^ 
ยุ่งยาก	j u ng^ j aa k^ 
ยุ่งเกี่ยว	j u ng^ k iia w^ 
ยุ้ง	j u ng^ 
ยโสธร	j a s oo th @@ n^ 
ย่อ	j @@ 
ย่อท้อ	j @@ th @@ 
ย่อม	j @ m^ 
ย่อม	j @@ m^ 
ย่อย	j @ j^ 
ย่อย	j @@ j^ 
ย่า	j aa 
ย่าง	j aa ng^ 
ย่าน	j aa n^ 
ย่ำ	j a m^ 
ย้อน	j @@ n^ 
ย้าย	j aa j^ 
ย้ำ	j a m^ 
ร	r @@ 
รณรงค์	r o n^ n a r o ng^ 
รถ	r o t^ 
รถประจำทาง	r o t^ pr a c a m^ th aa ng^ 
รถยนต์	r o t^ j o n^ 
รถยนต์	r o t^ j o n^ 
รถเมล์	r o t^ m ee 
รบ	r o p^ 
รบกวน	r o p^ k uua n^ 
รวดเร็ว	r uua t^ r e w^ 
รวบยอด	r uua p^ j @@ t^ 
รวบรวม	r uua p^ r uua m^ 
รวบรัด	r uua p^ r a t^ 
รวม	r uua m^ 
รส	r o t^ 
รสช.	r @@ s @@ ch @@ 
รสชาติ	r o t^ ch aa t^ 
รสนิยม	r o t^ n i j o m^ 
รหัส	r a h a t^ 
รอ	r @@ 
รอง	r @@ ng^ 
รองรับ	r @@ ng^ r a p^ 
รองเท้า	r @@ ng^ th aa w^ 
รอด	r @@ t^ 
รอดพ้น	r @@ t^ ph o n^ 
รอบ	r @@ p^ 
รอบคอบ	r @@ p^ kh @@ p^ 
รอย	r @@ j^ 
ระงับ	r a ng a p^ 
ระดม	r a d o m^ 
ระดับ	r a d a p^ 
ระดู	r a d uu 
ระบบ	r a b o p^ 
ระบอบ	r a b @@ p^ 
ระบาด	r a b aa t^ 
ระบาย	r a b aa j^ 
ระบุ	r a b u 
ระมัดระวัง	r a m a t^ r a w a ng^ 
ระยอง	r a j @@ ng^ 
ระยะ	r a j a 
ระลึก	r a l v k^ 
ระวัง	r a w a ng^ 
ระหว่าง	r a w aa ng^ 
ระเบิด	r a b qq t^ 
ระเบียบ	r a b iia p^ 
รัก	r a k^ 
รักษา	r a k^ s aa 
รักใคร่	r a k^ khr a j^ 
รังสรรค์	r a ng^ s a n^ 
รังสี	r a ng^ s ii 
รังเกียจ	r a ng^ k iia t^ 
รัชกาล	r a t^ ch a k aa n^ 
รัชมังคลาภิเษก	r a t^ ch a m a ng^ khl aa ph i s ee k^ 
รัชสมัย	r a t^ ch a s a m a j^ 
รัฐ	r a t^ 
รัฐธรรมนูญ	r a t^ th a th a m^ m a n uu n^ 
รัฐบาล	r a t^ th a b aa n^ 
รัฐประหาร	r a t^ th a pr a h aa n^ 
รัฐมนตรี	r a t^ th a m o n^ tr ii 
รัฐมนตรีว่าการ	r a t^ th a m o n^ tr ii w aa k aa n^ 
รัฐวิสาหกิจ	r a t^ w i s aa h a k i t^ 
รัฐศาสตร์	r a t^ th a s aa t^ 
รัฐสภา	r a t^ th a s a ph aa 
รัฐสภา	r a t^ th a s a ph aa 
รัตนโกสินทร์	r a t^ t a n a k oo s i n^ 
รัตนโกเศศ	r a t^ t a n a k oo s ee t^ 
รับ	r a p^ 
รับช่วง	r a p^ ch uua ng^ 
รับประทาน	r a p^ pr a th aa n^ 
รับผิดชอบ	r a p^ ph i t^ ch @@ p^ 
รับฟัง	r a p^ f a ng^ 
รับรอง	r a p^ r @@ ng^ 
รับราชการ	r a p^ r aa t^ ch a k aa n^ 
รับรู้	r a p^ r uu 
รับหน้า	r a p^ n aa 
รับเหมา	r a p^ m a w^ 
รับใช้	r a p^ ch a j^ 
รัสเซีย	r a t^ s iia 
รา	r aa 
รากฐาน	r aa k^ th aa n^ 
รากเหง้า	r aa k^ ng a w^ 
ราคะ	r aa kh a 
ราคา	r aa kh aa 
รางวัล	r aa ng^ w a n^ 
ราชการ	r aa t^ ch a k aa n^ 
ราชครู	r aa t^ ch a khr uu 
ราชธน	r aa t^ ch a th o n^ 
ราชบัณฑิต	r aa t^ ch a b a n^ d i t^ 
ราชประเพณี	r aa t^ ch a pr a ph ee n ii 
ราชมงคล	r aa t^ ch a m o ng^ kh o n^ 
ราชสมบัติ	r aa t^ ch a s o m^ b a t^ 
ราชอาณาจักร	r aa t^ ch a z aa n aa c a k^ 
ราบ	r aa p^ 
ราบรื่น	r aa p^ r vv n^ 
รามคำแหง	r aa m^ kh a m^ h xx ng^ 
รามเกียรติ์	r aa m^ m a k iia n^ 
ราย	r aa j^ 
รายการ	r aa j^ k aa n^ 
รายงาน	r aa j^ ng aa n^ 
รายจ่าย	r aa j^ c aa j^ 
รายชื่อ	r aa j^ ch vv 
รายละเอียด	r aa j^ l a z iia t^ 
รายได้	r aa j^ d aa j^ 
ราว	r aa w^ 
ราศี	r aa s ii 
ราษฎร	r aa t^ s a d @@ n^ 
รำ	r a m^ 
รำคาญ	r a m^ kh aa n^ 
รำลึก	r a m^ l v k^ 
ริดรอน	r i t^ r @@ n^ 
ริดสีดวง	r i t^ s ii d uua ng^ 
ริม	r i m^ 
ริเริ่ม	r i r qq m^ 
รีด	r ii t^ 
รีบ	r ii p^ 
รีบด่วน	r ii p^ d uua n^ 
รีบร้อน	r ii p^ r @@ n^ 
รีบเร่ง	r ii p^ r e ng^ 
รีพับลิกัน	r ii ph a p^ l i k a n^ 
รื่นรมย์	r vv n^ r o m^ 
รื้อ	r vv 
รุก	r u k^ 
รุกราน	r u k^ r aa n^ 
รุดหน้า	r u t^ n aa 
รุนแรง	r u n^ r xx ng^ 
รุมเร้า	r u m^ r a w^ 
รุ่งขึ้น	r u ng^ kh v n^ 
รุ่งเรือง	r u ng^ r vva ng^ 
รุ่งโรจน์	r u ng^ r oo t^ 
รุ่น	r u n^ 
รูป	r uu p^ 
รูปการณ์	r uu p^ k aa n^ 
รูปธรรม	r uu p^ p a th a m^ 
รูปร่าง	r uu p^ r aa ng^ 
รูปลักษณ์	r uu p^ l a k^ 
รูปแบบ	r uu p^ b xx p^ 
รูเบิล	r uu b q n^ 
รู้	r uu 
รู้จัก	r uu c a k^ 
รู้ดี	r uu d ii 
รู้ตัว	r uu t uua 
รู้สึก	r uu s v k^ 
รู้เท่าไม่ถึงการณ์	r uu th a w^ m a j^ th v ng^ k aa n^ 
รู้เรื่อง	r uu r vva ng^ 
ร่มเย็น	r o m^ j e n^ 
ร่วม	r uua m^ 
ร่วมงาน	r uua m^ ng aa n^ 
ร่วมมือ	r uua m^ m vv 
ร่วมสมัย	r uua m^ s a m a j^ 
ร่องรอย	r @@ ng^ r @@ j^ 
ร่าง	r aa ng^ 
ร่างกาย	r aa ng^ k aa j^ 
ร่าเริง	r aa r qq ng^ 
ร่ำรวย	r a m^ r uua j^ 
ร่ำไป	r a m^ p a j^ 
ร้อง	r @@ ng^ 
ร้องขอ	r @@ ng^ kh @@ 
ร้องเพลง	r @@ ng^ phl ee ng^ 
ร้องเรียน	r @@ ng^ r iia n^ 
ร้องไห้	r @@ ng^ h aa j^ 
ร้อน	r @@ n^ 
ร้อย	r @@ j^ 
ร้อยตำรวจเอก	r @@ j^ t a m^ r uua t^ z ee k^ 
ร้อยละ	r @@ j^ l a 
ร้อยเอ็ด	r @@ j^ z e t^ 
ร้าน	r aa n^ 
ร้าย	r aa j^ 
ร้ายกาจ	r aa j^ k aa t^ 
ร้ายแรง	r aa j^ r xx ng^ 
ฤดู	r v d uu 
ฤทธิ์	r i t^ 
ล	l @@ 
ลง	l o ng^ 
ลงทุน	l o ng^ th u n^ 
ลงนาม	l o ng^ n aa m^ 
ลงมือ	l o ng^ m vv 
ลงรอย	l o ng^ r @@ j^ 
ลงเอย	l o ng^ z qq j^ 
ลงโทษ	l o ng^ th oo t^ 
ลด	l o t^ 
ลดทอน	l o t^ th @@ n^ 
ลบ	l o p^ 
ลม	l o m^ 
ลวดลาย	l uua t^ l aa j^ 
ลอกเลียน	l @@ k^ l iia n^ 
ลอง	l @@ ng^ 
ลอนดอน	l @ n^ d @ n^ 
ลอบ	l @@ p^ 
ลอย	l @@ j^ 
ลอยฟ้า	l @@ j^ f aa 
ละ	l a 
ละคร	l a kh @@ n^ 
ละทิ้ง	l a th i ng^ 
ละออง	l a z @@ ng^ 
ละอาย	l a z aa j^ 
ละเมิด	l a m qq t^ 
ละเลย	l a l qq j^ 
ละเล่น	l a l e n^ 
ละเอียด	l a z iia t^ 
ละเอียดลออ	l a z iia t^ l a z @@ 
ละเอียดอ่อน	l a z iia t^ z @@ n^ 
ละแวก	l a w xx k^ 
ลักกี้	l a k^ k ii 
ลักลอบ	l a k^ l @@ p^ 
ลักลั่น	l a k^ l a n^ 
ลักษณะ	l a k^ s a n a 
ลังกา	l a ng^ k aa 
ลังกาวี	l a ng^ k aa w ii 
ลังเล	l a ng^ l ee 
ลัทธิ	l a t^ th i 
ลับ	l a p^ 
ลั่น	l a n^ 
ลา	l aa 
ลาง	l aa ng^ 
ลาด	l aa t^ 
ลาดชัน	l aa t^ ch a n^ 
ลายมือ	l aa j^ m vv 
ลายสือ	l aa j^ s vv 
ลาว	l aa w^ 
ลาออก	l aa z @@ k^ 
ลำ	l a m^ 
ลำคอ	l a m^ kh @@ 
ลำดับ	l a m^ d a p^ 
ลำน้ำ	l a m^ n aa m^ 
ลำบาก	l a m^ b aa k^ 
ลำพัง	l a m^ ph a ng^ 
ลำพูน	l a m^ ph uu n^ 
ลำเลียง	l a m^ l iia ng^ 
ลำเอียง	l a m^ z iia ng^ 
ลิง	l i ng^ 
ลิไท	l i th a j^ 
ลิ้น	l i n^ 
ลีลา	l ii l aa 
ลี้ลับ	l ii l a p^ 
ลึก	l v k^ 
ลึกซึ้ง	l v k^ s v ng^ 
ลึกลับ	l v k^ l a p^ 
ลืม	l vv m^ 
ลือ	l vv 
ลุ	l u 
ลุก	l u k^ 
ลุกฮือ	l u k^ h vv 
ลุง	l u ng^ 
ลุงชาน	l u ng^ ch aa n^ 
ลุล่วง	l u l uua ng^ 
ลุ่มน้ำ	l u m^ n aa m^ 
ลุ่มลึก	l u m^ l v k^ 
ลูก	l uu k^ 
ลูกค้า	l uu k^ kh aa 
ลูกจ้าง	l uu k^ c aa ng^ 
ลูกตา	l uu k^ t aa 
ลูกน้อง	l uu k^ n @@ ng^ 
ลูกบาศก์	l uu k^ b aa t^ 
ลูกผสม	l uu k^ ph a s o m^ 
ลูกศิษย์	l uu k^ s i t^ 
ลูกสาว	l uu k^ s aa w^ 
ลูกหนี้	l uu k^ n ii 
ลูกเขย	l uu k^ kh qq j^ 
ลูกโซ่	l uu k^ s oo 
ลูบ	l uu p^ 
ลูเซียโน	l uu s iia n oo 
ลู่ทาง	l uu th aa ng^ 
ล่มจม	l o m^ c o m^ 
ล่วง	l uua ng^ 
ล่วงหน้า	l uua ng^ n aa 
ล่ะ	l a 
ล่าง	l aa ng^ 
ล่าช้า	l aa ch aa 
ล่าสุด	l aa s u t^ 
ล้นพ้น	l o n^ ph o n^ 
ล้ม	l o m^ 
ล้มล้าง	l o m^ l aa ng^ 
ล้มเหลว	l o m^ l ee w^ 
ล้วน	l uua n^ 
ล้วนแต่	l uua n^ t xx 
ล้วนแล้ว	l uua n^ l xx w^ 
ล้อม	l @@ m^ 
ล้อเลียน	l @@ l iia n^ 
ล้อเล่น	l @@ l e n^ 
ล้าง	l aa ng^ 
ล้าน	l aa n^ 
ล้านนา	l aa n^ n aa 
ล้าหลัง	l aa l a ng^ 
วง	w o ng^ 
วงการ	w o ng^ k aa n^ 
วงจร	w o ng^ c @@ n^ 
วงศ์วรรณ	w o ng^ w a n^ 
วงศ์วานิช	w o ng^ w aa n i t^ 
วงศ์ๆ	w o ng^ w o ng^ 
วงเงิน	w o ng^ ng q n^ 
วน	w o n^ 
วนเกษตร	w a n a k a s ee t^ 
วรรค	w a k^ 
วรรณกรรม	w a n^ n a k a m^ 
วรรณคดี	w a n^ n a kh a d ii 
วรรณศิลป์	w a n^ n a s i n^ 
วรรณะ	w a n^ n a 
วรศักดิ์	w @@ r a s a k^ 
วลี	w a l ii 
วสันต์	w a s a n^ 
วอชิงตัน	w @@ ch i ng^ t a n^ 
วอร์ซอ	w @@ s @@ 
วัคซีน	w a k^ s ii n^ 
วัง	w a ng^ 
วังกานนท์	w a ng^ k aa n o n^ 
วัชพืช	w a t^ ch a ph vv t^ 
วัฒนธรรม	w a t^ th a n a th a m^ 
วัด	w a t^ 
วัตถุ	w a t^ th u 
วัตถุดิบ	w a t^ th u d i p^ 
วัตถุธรรม	w a t^ th u th a m^ 
วัตถุนิยม	w a t^ th u n i j o m^ 
วัตถุประสงค์	w a t^ th u pr a s o ng^ 
วัน	w a n^ 
วันที่	w a n^ th ii 
วันนี้	w a n^ n ii 
วันหนึ่ง	w a n^ n v ng^ 
วันเกิด	w a n^ k qq t^ 
วัย	w a j^ 
วัยรุ่น	w a j^ r u n^ 
วัลลีย์	w a n^ l ii 
วัสดุ	w a t^ s a d u 
วาง	w aa ng^ 
วางแผน	w aa ng^ ph xx n^ 
วาจา	w aa c aa 
วาด	w aa t^ 
วาทศิลป์	w aa th a s i n^ 
วายร้าย	w aa j^ r aa j^ 
วารสาร	w aa r a s aa n^ 
วาระ	w aa r a 
วาสนา	w aa t^ s a n aa 
วิกฤตการณ์	w i kr i t^ t a k aa n^ 
วิกฤติ	w i kr i t^ 
วิกฤติการณ์	w i kr i t^ t a k aa n^ 
วิกลจริต	w i k o n^ c a r i t^ 
วิงเวียน	w i ng^ w iia n^ 
วิจัย	w i c a j^ 
วิจารณญาณ	w i c aa r a n a j aa n^ 
วิจารณ์	w i c aa n^ 
วิจิตร	w i c i t^ 
วิชา	w i ch aa 
วิชาการ	w i ch aa k aa n^ 
วิชาชีพ	w i ch aa ch ii p^ 
วิญญาณ	w i n^ j aa n^ 
วิตก	w i t o k^ 
วิตกกังวล	w i t o k^ k a ng^ w o n^ 
วิตามิน	w i t aa m i n^ 
วิถี	w i th ii 
วิถีชีวิต	w i th ii ch ii w i t^ 
วิถีทาง	w i th ii th aa ng^ 
วิทยา	w i t^ th a j aa 
วิทยาการ	w i t^ th a j aa k aa n^ 
วิทยาลัย	w i t^ th a j aa l a j^ 
วิทยาศาสตร์	w i t^ th a j aa s aa t^ 
วิทยาเขต	w i t^ th a j aa kh ee t^ 
วิทยุ	w i t^ th a j u 
วิธี	w i th ii 
วิธีการ	w i th ii k aa n^ 
วินัย	w i n a j^ 
วินาศกรรม	w i n aa t^ s a k a m^ 
วินิจฉัย	w i n i t^ ch a j^ 
วิพากษ์	w i ph aa k^ 
วิมล	w i m o n^ 
วิมัตินิยม	w i m a t^ n i j o m^ 
วิริยะ	w i r i j a 
วิวัฒนาการ	w i w a t^ th a n aa k aa n^ 
วิศว	w i t^ s a w a 
วิศวกร	w i t^ s a w a k @@ n^ 
วิศวกรรม	w i t^ s a w a k a m^ 
วิศวกรรมศาสตร์	w i t^ s a w a k a m^ m a s aa t^ 
วิสัทลักษณ์	w i s a t^ th a l a k^ 
วิสัย	w i s a j^ 
วิสามัญ	w i s aa m a n^ 
วิอาญา	w i z aa j aa 
วิเคราะห์	w i khr @ 
วิเชษฐ	w i ch ee t^ 
วิเทศธนกิจ	w i th ee t^ th a n a k i t^ 
วิเศษ	w i s ee t^ 
วิเศษณ์	w i s ee t^ 
วิโรจน์	w i r oo t^ 
วิ่ง	w i ng^ 
วิ่งเต้น	w i ng^ t e n^ 
วีรบุรุษ	w ii r a b u r u t^ 
วีระ	w ii r a 
วุฒิปรีชา	w u t^ th i pr ii ch aa 
วุฒิสภา	w u t^ th i s a ph aa 
วุ่นวาย	w u n^ w aa j^ 
วูบ	w uu p^ 
ว่า	w aa 
ว่าการ	w aa k aa n^ 
ว่าง	w aa ng^ 
ว่างงาน	w aa ng^ ng aa n^ 
ว่างเปล่า	w aa ng^ pl aa w^ 
ว่าจ้าง	w aa c aa ng^ 
ว้าวุ่น	w aa w u n^ 
ว้าเหว่	w aa w ee 
ศก	s o k^ 
ศตวรรษ	s a t a w a t^ 
ศพ	s o p^ 
ศรัทธา	s a t^ th aa 
ศรี	s ii 
ศรีปราชญ์	s ii pr aa t^ 
ศรีเมือง	s ii m vva ng^ 
ศักดินา	s a k^ d i n aa 
ศักดิ์	s a k^ 
ศักดิ์ศรี	s a k^ s ii 
ศักดิ์สิทธิ์	s a k^ s i t^ 
ศักยภาพ	s a k^ k a j a ph aa p^ 
ศักราช	s a k^ k a r aa t^ 
ศัตรู	s a t^ tr uu 
ศัพท์	s a p^ 
ศาล	s aa n^ 
ศาสดา	s aa t^ s a d aa 
ศาสตร์	s aa t^ 
ศาสนจักร	s aa t^ s a n a c a k^ 
ศาสนสถาน	s aa t^ s a n a s a th aa n^ 
ศาสนา	s aa t^ s a n aa 
ศิรินวกุล	s i r i n a w a k u n^ 
ศิลปกรรม	s i n^ l a p a k a m^ 
ศิลปวัฒนธรรม	s i n^ l a p a w a t^ th a n a th a m^ 
ศิลปวัตถุ	s i n^ l a p a w a t^ th u 
ศิลปวิทยา	s i n^ l a p a w i t^ th a j aa 
ศิลปหัตถกรรม	s i n^ l a p a h a t^ th a k a m^ 
ศิลปะ	s i n^ l a p a 
ศิลปากร	s i n^ l a p aa k @@ n^ 
ศิลปิน	s i n^ l a p i n^ 
ศิลป์	s i n^ 
ศิลาจารึก	s i l aa c aa r v k^ 
ศิลาอ่อน	s i l aa z @@ n^ 
ศิวลึงค์	s i w a l v ng^ 
ศิษย์	s i t^ 
ศีรษะ	s ii s a 
ศีล	s ii n^ 
ศีลธรรม	s ii n^ l a th a m^ 
ศึก	s v k^ 
ศึกษา	s v k^ s aa 
ศึกษาธิการ	s v k^ s aa th i k aa n^ 
ศุกร์	s u k^ 
ศูนย์	s uu n^ 
ศูนย์กลาง	s uu n^ kl aa ng^ 
ส.ส.	s @@ s @@ 
สกปรก	s o k^ k a pr o k^ 
สกัด	s a k a t^ 
สกุล	s a k u n^ 
สงขลา	s o ng^ khl aa 
สงคราม	s o ng^ khr aa m^ 
สงครามโลก	s o ng^ khr aa m^ l oo k^ 
สงฆ์	s o ng^ 
สงบ	s a ng o p^ 
สงบสุข	s a ng o p^ s u k^ 
สงสัย	s o ng^ s a j^ 
สงสาร	s o ng^ s aa n^ 
สงเคราะห์	s o ng^ khr @ 
สง่า	s a ng aa 
สด	s o t^ 
สดชื่น	s o t^ ch vv n^ 
สตรี	s a t^ tr ii 
สตัฟฟ์	s a t a p^ 
สติ	s a t i 
สติปัญญา	s a t i p a n^ j aa 
สถาน	s a th aa n^ 
สถานการณ์	s a th aa n a k aa n^ 
สถานที่	s a th aa n^ th ii 
สถานภาพ	s a th aa n a ph aa p^ 
สถานะ	s a th aa n a 
สถานี	s a th aa n ii 
สถาบัน	s a th aa b a n^ 
สถาปนา	s a th aa p a n aa 
สถาปัตยกรรม	s a th aa p a t^ t a j a k a m^ 
สถิติ	s a th i t i 
สถูป	s a th uu p^ 
สนทนา	s o n^ th a n aa 
สนอง	s a n @@ ng^ 
สนองตอบ	s a n @@ ng^ t @@ p^ 
สนับสนุน	s a n a p^ s a n u n^ 
สนั่น	s a n a n^ 
สนาม	s a n aa m^ 
สนามรบ	s a n aa m^ r o p^ 
สนิท	s a n i t^ 
สนิทสนม	s a n i t^ s a n o m^ 
สนุก	s a n u k^ 
สนุกสนาน	s a n u k^ s a n aa n^ 
สนเทศ	s o n^ th ee t^ 
สนใจ	s o n^ c a j^ 
สบถ	s a b o t^ 
สบาย	s a b aa j^ 
สบายใจ	s a b aa j^ c a j^ 
สภา	s a ph aa 
สภาพ	s a ph aa p^ 
สภาพการณ์	s a ph aa p^ k aa n^ 
สภาพแวดล้อม	s a ph aa p^ w xx t^ l @@ m^ 
สภาวการณ์	s a ph aa w a k aa n^ 
สภาวะ	s a ph aa w a 
สม	s o m^ 
สมควร	s o m^ kh uua n^ 
สมจริง	s o m^ c i ng^ 
สมชัย	s o m^ ch a j^ 
สมณศักดิ์	s a m a n a s a k^ 
สมดุล	s o m^ d u n^ 
สมดุลยภาพ	s o m^ d u n^ j a ph aa p^ 
สมดุลย์	s o m^ d u n^ 
สมถะ	s a m a th a 
สมทบ	s o m^ th o p^ 
สมบัติ	s o m^ b a t^ 
สมบูรณาญาสิทธิราชย์	s o m^ b uu r a n aa j aa s i t^ th i r aa t^ 
สมบูรณ์	s o m^ b uu n^ 
สมประกอบ	s o m^ pr a k @@ p^ 
สมภาร	s o m^ ph aa n^ 
สมมุติ	s o m^ m u t^ 
สมรรถนะ	s a m a t^ th a n a 
สมรรถภาพ	s a m a t^ th a ph aa p^ 
สมรส	s o m^ r o t^ 
สมศรี	s o m^ s ii 
สมอง	s a m @@ ng^ 
สมอเรียง	s a m @@ r iia ng^ 
สมัคร	s a m a k^ 
สมัครใจ	s a m a k^ c a j^ 
สมัย	s a m a j^ 
สมัยก่อน	s a m a j^ k @@ n^ 
สมาคม	s a m aa kh o m^ 
สมาชิก	s a m aa ch i k^ 
สมาชิกภาพ	s a m aa ch i k^ k a ph aa p^ 
สมาธิ	s a m aa th i 
สมาน	s a m aa n^ 
สมุด	s a m u t^ 
สมุน	s a m u n^ 
สมุย	s a m u j^ 
สมเด็จ	s o m^ d e t^ 
สมเหตุสมผล	s o m^ h ee t^ s o m^ ph o n^ 
สม่ำเสมอ	s a m a m^ s a m qq 
สยาม	s a j aa m^ 
สรง	s o ng^ 
สรงน้ำ	s o ng^ n aa m^ 
สรณะ	s a r a n a 
สรรค์	s a n^ 
สรรพสิ่ง	s a p^ ph a s i ng^ 
สรรหา	s a n^ h aa 
สระ	s a r a 
สรีระ	s a r ii r a 
สรุป	s a r u p^ 
สรุป	s a r u p^ 
สร้าง	s aa ng^ 
สร้างสม	s aa ng^ s o m^ 
สร้างสรรค์	s aa ng^ s a n^ 
สฤษดิ์	s a r i t^ 
สละ	s a l a 
สลักสำคัญ	s a l a k^ s a m^ kh a n^ 
สลับ	s a l a p^ 
สลับ	s a l a p^ 
สลัม	s a l a m^ 
สลาย	s a l aa j^ 
สวน	s uua n^ 
สวนทาง	s uua n^ th aa ng^ 
สวย	s uua j^ 
สวยงาม	s uua j^ ng aa m^ 
สวรรค์	s a w a n^ 
สวัสดิการ	s a w a t^ d i k aa n^ 
สวัสดิภาพ	s a w a t^ d i ph aa p^ 
สวัสดิ์	s a w a t^ 
สวีเดน	s a w ii d e n^ 
สว่าง	s a w aa ng^ 
สหกรณ์	s a h a k @@ n^ 
สหประชาชาติ	s a h a pr a ch aa ch aa t^ 
สหพันธ์	s a h a ph a n^ 
สหภาพ	s a h a ph aa p^ 
สหภาพโซเวียต	s a h a ph aa p^ s oo w iia t^ 
สหรัฐ	s a h a r a t^ 
สหรัฐอเมริกา	s a h a r a t^ z a m ee r i k aa 
สหวิทยาลัย	s a h a w i t^ th a j aa l a j^ 
สหอาชีวะ	s a h a z aa ch ii w a 
สอง	s @@ ng^ 
สอดคล้อง	s @@ t^ khl @@ ng^ 
สอดส่อง	s @@ t^ s @@ ng^ 
สอดแทรก	s @@ t^ s xx k^ 
สอน	s @@ n^ 
สอบ	s @@ p^ 
สอบถาม	s @@ p^ th aa m^ 
สอบสวน	s @@ p^ s uua n^ 
สอบไล่	s @@ p^ l a j^ 
สะกด	s a k o t^ 
สะดวก	s a d uua k^ 
สะดุด	s a d u t^ 
สะท้อน	s a th @@ n^ 
สะบั้น	s a b a n^ 
สะสม	s a s o m^ 
สะสาง	s a s aa ng^ 
สะอาด	s a z aa t^ 
สะเทือน	s a th vva n^ 
สัก	s a k^ 
สังกัด	s a ng^ k a t^ 
สังคม	s a ng^ kh o m^ 
สังคมนิยม	s a ng^ kh o m^ n i j o m^ 
สังคมวิทยา	s a ng^ kh o m^ w i t^ th a j aa 
สังคมศาสตร์	s a ng^ kh o m^ s aa t^ 
สังฆาธิการ	s a ng^ kh aa th i k aa n^ 
สังสรรค์	s a ng^ s a n^ 
สังหาร	s a ng^ h aa n^ 
สังเกต	s a ng^ k ee t^ 
สังเกตการณ์	s a ng^ k ee t^ k aa n^ 
สังเขป	s a ng^ kh ee p^ 
สังเคราะห์	s a ng^ khr @ 
สัจจะ	s a t^ c a 
สัจธรรม	s a t^ c a th a m^ 
สัญจร	s a n^ c @@ n^ 
สัญชาตญาณ	s a n^ ch aa t^ t a j aa n^ 
สัญญา	s a n^ j aa 
สัญลักษณ์	s a n^ j a l a k^ 
สัณฐาน	s a n^ th aa n^ 
สัดส่วน	s a t^ s uua n^ 
สัตย์	s a t^ 
สัตว์	s a t^ 
สัตว์น้ำ	s a t^ n aa m^ 
สัตว์ป่า	s a t^ p aa 
สันดาน	s a n^ d aa n^ 
สันติ	s a n^ t i 
สันติภาพ	s a n^ t i ph aa p^ 
สันนิษฐาน	s a n^ n i t^ th aa n^ 
สันสกฤต	s a n^ s a kr i t^ 
สันโดษ	s a n^ d oo t^ 
สับสน	s a p^ s o n^ 
สัปดาห์	s a p^ d aa 
สัมปทาน	s a m^ p a th aa n^ 
สัมผัส	s a m^ ph a t^ 
สัมพันธภาพ	s a m^ ph a n^ th a ph aa p^ 
สัมพันธมิตร	s a m^ ph a n^ th a m i t^ 
สัมพันธ์	s a m^ ph a n^ 
สัมภาษณ์	s a m^ ph aa t^ 
สัมมนา	s a m^ m a n aa 
สัมมา	s a m^ m aa 
สัมฤทธิผล	s a m^ r i t^ ph o n^ 
สัมฤทธิ์	s a m^ r i t^ 
สัมโพธิญาณ	s a m^ ph oo th i j aa n^ 
สั่ง	s a ng^ 
สั่งสม	s a ng^ s o m^ 
สั่งสอน	s a ng^ s @@ n^ 
สั่น	s a n^ 
สั้น	s a n^ 
สาก	s aa k^ 
สากล	s aa k o n^ 
สาขา	s aa kh aa 
สาด	s aa t^ 
สาธารณชน	s aa th aa r a n a ch o n^ 
สาธารณประโยชน์	s aa th aa r a n a pr a j oo t^ 
สาธารณรัฐ	s aa th aa r a n a r a t^ 
สาธารณสุข	s aa th aa r a n a s u k^ 
สาธารณะ	s aa th aa r a n a 
สาธารณูปโภค	s aa th aa r a n uu p a ph oo k^ 
สาม	s aa m^ 
สามนต์	s aa m o n^ 
สามัคคี	s aa m a k^ kh ii 
สามัญ	s aa m a n^ 
สามัญชน	s aa m a n^ ch o n^ 
สามารถ	s aa m aa t^ 
สามี	s aa m ii 
สามเณร	s aa m^ m a n ee n^ 
สาย	s aa j^ 
สายตา	s aa j^ t aa 
สายลม	s aa j^ l o m^ 
สาร	s aa n^ 
สารคดี	s aa r a kh a d ii 
สารพิษ	s aa n^ ph i t^ 
สารวัตร	s aa r a w a t^ 
สารสนเทศ	s aa r a s o n^ th ee t^ 
สาระ	s aa r a 
สารเคมี	s aa n^ kh ee m ii 
สาว	s aa w^ 
สาวก	s aa w o k^ 
สาหัส	s aa h a t^ 
สาเหตุ	s aa h ee t^ 
สำคัญ	s a m^ kh a n^ 
สำนวน	s a m^ n uua n^ 
สำนัก	s a m^ n a k^ 
สำนักงาน	s a m^ n a k^ ng aa n^ 
สำนักพิมพ์	s a m^ n a k^ ph i m^ 
สำนึก	s a m^ n v k^ 
สำรวจ	s a m^ r uua t^ 
สำราญ	s a m^ r aa n^ 
สำริด	s a m^ r i t^ 
สำหรับ	s a m^ r a p^ 
สำเริง	s a m^ r qq ng^ 
สำเร็จ	s a m^ r e t^ 
สำเร็จรูป	s a m^ r e t^ r uu p^ 
สำแดง	s a m^ d xx ng^ 
สิ	s i 
สิงหาคม	s i ng^ h aa kh o m^ 
สิงห์	s i ng^ 
สิทธิ	s i t^ 
สิทธิ	s i t^ th i 
สิทธิ์	s i t^ 
สิทธิ์ขาด	s i t^ kh aa t^ 
สินค้า	s i n^ kh aa 
สินทรัพย์	s i n^ s a p^ 
สินเชื่อ	s i n^ ch vva 
สิบ	s i p^ 
สิริกิติ์	s i r i k i t^ 
สิริสัมพันธ์	s i r i s a m^ ph a n^ 
สิ่ง	s i ng^ 
สิ่งของ	s i ng^ kh @@ ng^ 
สิ่งทอ	s i ng^ th @@ 
สิ่งมีชีวิต	s i ng^ m ii ch ii w i t^ 
สิ่งแวดล้อม	s i ng^ w xx t^ l @@ m^ 
สิ่งใด	s i ng^ d a j^ 
สิ้น	s i n^ 
สิ้นสุด	s i n^ s u t^ 
สิ้นหวัง	s i n^ w a ng^ 
สิ้นเชิง	s i n^ ch qq ng^ 
สิ้นเนื้อประดาตัว	s i n^ n vva pr a d aa t uua 
สิ้นเปลือง	s i n^ pl vva ng^ 
สิ้นใจ	s i n^ c a j^ 
สี	s ii 
สี่	s ii 
สี่เหลี่ยม	s ii l iia m^ 
สึก	s v k^ 
สืบ	s vv p^ 
สืบต่อ	s vv p^ t @@ 
สืบทอด	s vv p^ th @@ t^ 
สืบพันธุ์	s vv p^ ph a n^ 
สืบสวน	s vv p^ s uua n^ 
สืบเนื่อง	s vv p^ n vva ng^ 
สื่อ	s vv 
สื่อกลาง	s vv kl aa ng^ 
สื่อมวลชน	s vv m uua n^ ch o n^ 
สื่อสาร	s vv s aa n^ 
สุกเอาเผากิน	s u k^ z a w^ ph a w^ k i n^ 
สุข	s u k^ 
สุขภาพ	s u k^ kh a ph aa p^ 
สุขภาพจิต	s u k^ kh a ph aa p^ c i t^ 
สุขศึกษา	s u k^ kh a s v k^ s aa 
สุขสบาย	s u k^ s a b aa j^ 
สุขเวทนา	s u k^ kh a w ee th a n aa 
สุขใจ	s u k^ c a j^ 
สุคนธ์	s u kh o n^ 
สุจริต	s u t^ c a r i t^ 
สุจินดา	s u c i n^ d aa 
สุด	s u t^ 
สุดขีด	s u t^ kh ii t^ 
สุดท้อง	s u t^ th @@ ng^ 
สุดท้าย	s u t^ th aa j^ 
สุดยอด	s u t^ j @@ t^ 
สุดวิสัย	s u t^ w i s a j^ 
สุธี	s u th ii 
สุนทร	s u n^ th @@ n^ 
สุนทรภู่	s u n^ th @@ n^ ph uu 
สุนทราภรณ์	s u n^ th a r aa ph @@ n^ 
สุนทรียภาพ	s u n^ th a r ii j a ph aa p^ 
สุนทรเวช	s u n^ th @@ r a w ee t^ 
สุนัข	s u n a k^ 
สุนีย์	s u n ii 
สุพรรณ	s u ph a n^ 
สุภาพ	s u ph aa p^ 
สุรา	s u r aa 
สุเทพ	s u th ee p^ 
สุโขทัย	s u kh oo th a j^ 
สุ่ม	s u m^ 
สูง	s uu ng^ 
สูงสุด	s uu ng^ s u t^ 
สูงส่ง	s uu ng^ s o ng^ 
สูงอายุ	s uu ng^ z aa j u 
สูญ	s uu n^ 
สูญพันธุ์	s uu n^ ph a n^ 
สูญหาย	s uu n^ h aa j^ 
สูญเปล่า	s uu n^ pl aa w^ 
สูญเสีย	s uu n^ s iia 
สูบ	s uu p^ 
สู่	s uu 
สู้	s uu 
สเมอร์ดิยาคอฟ	s a m qq d i j aa kh @@ p^ 
สโมสร	s a m oo s @@ n^ 
ส่ง	s o ng^ 
ส่งออก	s o ng^ z @@ k^ 
ส่งเสริม	s o ng^ s qq m^ 
ส่งเสีย	s o ng^ s iia 
ส่วน	s uua n^ 
ส่วนกลาง	s uua n^ kl aa ng^ 
ส่วนช่วย	s uua n^ ch uua j^ 
ส่วนตัว	s uua n^ t uua 
ส่วนน้อย	s uua n^ n @@ j^ 
ส่วนประกอบ	s uua n^ pr a k @@ p^ 
ส่วนมาก	s uua n^ m aa k^ 
ส่วนย่อย	s uua n^ j @ j^ 
ส่วนรวม	s uua n^ r uua m^ 
ส่วนร่วม	s uua n^ r uua m^ 
ส่วนหนึ่ง	s uua n^ n v ng^ 
ส่วนเสีย	s uua n^ s iia 
ส่วนใหญ่	s uua n^ j a j^ 
ส่วนได้	s uua n^ d aa j^ 
ส่วย	s uua j^ 
ส่อ	s @@ 
ส่อง	s @ ng^ 
หก	h o k^ 
หงุดหงิด	ng u t^ ng i t^ 
หญิง	j i ng^ 
หดหาย	h o t^ h aa j^ 
หน	h o n^ 
หนทาง	h o n^ th aa ng^ 
หนอง	n @@ ng^ 
หนัก	n a k^ 
หนักหน่วง	n a k^ n uua ng^ 
หนักใจ	n a k^ c a j^ 
หนัง	n a ng^ 
หนังสือ	n a ng^ s vv 
หนังสือพิมพ์	n a ng^ s vv ph i m^ 
หนาม	n aa m^ 
หนาว	n aa w^ 
หนาแน่น	n aa n x n^ 
หนี	n ii 
หนี้	n ii 
หนึ่ง	n v ng^ 
หนุน	n u n^ 
หนุ่ม	n u m^ 
หนู	n uu 
หน่วย	n uua j^ 
หน่วยงาน	n uua j^ ng aa n^ 
หน่อย	n @ j^ 
หน้า	n aa 
หน้าตา	n aa t aa 
หน้าที่	n aa th ii 
หน้ามืด	n aa m vv t^ 
หน้าไหว้หลังหลอก	n aa w a j^ l a ng^ l @@ k^ 
หมด	m o t^ 
หมวด	m uua t^ 
หมอ	m @@ 
หมอนวด	m @@ n uua t^ 
หมัก	m a k^ 
หมัน	m a n^ 
หมา	m aa 
หมาด	m aa t^ 
หมาย	m aa j^ 
หมายความ	m aa j^ khw aa m^ 
หมายจับ	m aa j^ c a p^ 
หมายถึง	m aa j^ th v ng^ 
หมายเลข	m aa j^ l ee k^ 
หมื่น	m vv n^ 
หมุน	m u n^ 
หมุนเวียน	m u n^ w iia n^ 
หมู	m uu 
หมู่	m uu 
หมู่บ้าน	m uu b aa n^ 
หมู่เกาะ	m uu k @ 
หม่อมราชวงศ์	m @ m^ r aa t^ ch a w o ng^ 
หม้อ	m @@ 
หยั่งเสียง	j a ng^ s iia ng^ 
หยิบ	j i p^ 
หยิบยก	j i p^ j o k^ 
หยิ่ง	j i ng^ 
หยุด	j u t^ 
หยุดนิ่ง	j u t^ n i ng^ 
หยุดยั้ง	j u t^ j a ng^ 
หย่อน	j @ n^ 
หย่อนยาน	j @ n^ j aa n^ 
หย่อนใจ	j @ n^ c a j^ 
หย่า	j aa 
หย่าร้าง	j aa r aa ng^ 
หรอก	r @@ k^ 
หรือ	r vv 
หรือยัง	r vv j a ng^ 
หรือเปล่า	r vv pl aa w^ 
หรูหรา	r uu r aa 
หลง	l o ng^ 
หลงเหลือ	l o ng^ l vva 
หลบ	l o p^ 
หลบหนี	l o p^ n ii 
หลบหลีก	l o p^ l ii k^ 
หลวง	l uua ng^ 
หลวม	l uua m^ 
หลอก	l @@ k^ 
หลอกลวง	l @@ k^ l uua ng^ 
หลอม	l @@ m^ 
หลัก	l a k^ 
หลักการ	l a k^ k aa n^ 
หลักฐาน	l a k^ th aa n^ 
หลักทรัพย์	l a k^ s a p^ 
หลักธรรม	l a k^ th a m^ 
หลักสูตร	l a k^ s uu t^ 
หลักเกณฑ์	l a k^ k ee n^ 
หลัง	l a ng^ 
หลังจาก	l a ng^ c aa k^ 
หลับ	l a p^ 
หลับนอน	l a p^ n @@ n^ 
หลั่งไหล	l a ng^ l a j^ 
หลากหลาย	l aa k^ l aa j^ 
หลาน	l aa n^ 
หลาย	l aa j^ 
หลีก	l ii k^ 
หลีกภัย	l ii k^ ph a j^ 
หลีกหนี	l ii k^ n ii 
หลีกเลี่ยง	l ii k^ l iia ng^ 
หลุด	l u t^ 
หลุดพ้น	l u t^ ph o n^ 
หล่อ	l @@ 
หวง	h uua ng^ 
หวงแหน	h uua ng^ h xx n^ 
หวน	h uua n^ 
หวัง	w a ng^ 
หวั่นกลัว	w a n^ kl uua 
หวั่นไหว	w a n^ w a j^ 
หวาดกลัว	w aa t^ kl uua 
หวาดระแวง	w aa t^ r a w xx ng^ 
หวาน	w aa n^ 
หอ	h @@ 
หอการค้า	h @@ k aa n^ kh aa 
หอม	h @@ m^ 
หักล้าง	h a k^ l aa ng^ 
หัตถกรรม	h a t^ th a k a m^ 
หัน	h a n^ 
หันเห	h a n^ h ee 
หัว	h uua 
หัวข้อ	h uua kh @@ 
หัวคะแนน	h uua kh a n xx n^ 
หัวปี	h uua p ii 
หัวรบ	h uua r o p^ 
หัวรุนแรง	h uua r u n^ r xx ng^ 
หัวหน้า	h uua n aa 
หัวเมือง	h uua m vva ng^ 
หัวเราะ	h uua r @ 
หัวเลี้ยวหัวต่อ	h uua l iia w^ h uua t @@ 
หัวใจ	h uua c a j^ 
หา	h aa 
หาก	h aa k^ 
หากแต่	h aa k^ t xx 
หาดใหญ่	h aa t^ j a j^ 
หาทาง	h aa th aa ng^ 
หาย	h aa j^ 
หายนะ	h aa j^ j a n a 
หายใจ	h aa j^ c a j^ 
หารือ	h aa r vv 
หาว่า	h aa w aa 
หาเสียง	h aa s iia ng^ 
หาไม่	h aa m a j^ 
หิน	h i n^ 
หิว	h i w^ 
หิวโหย	h i w^ h oo j^ 
หึ	h v 
หุ้น	h u n^ 
หุ้ม	h u m^ 
หู	h uu 
หูตึง	h uu t v ng^ 
ห่วงใย	h uua ng^ j a j^ 
ห่าง	h aa ng^ 
ห่างเหิน	h aa ng^ h qq n^ 
ห่างไกล	h aa ng^ kl a j^ 
ห้วยขาแข้ง	h uua j^ kh aa kh x ng^ 
ห้อง	h @ ng^ 
ห้องนอน	h @ ng^ n @@ n^ 
ห้องน้ำ	h @ ng^ n aa m^ 
ห้องสมุด	h @ ng^ s a m u t^ 
ห้องเรียน	h @ ng^ r iia n^ 
ห้า	h aa 
ห้าม	h aa m^ 
อคติ	z a kh a t i 
องคภาวะ	z o ng^ kh a ph aa w a 
องค์	z o ng^ 
องค์กร	z o ng^ k @@ n^ 
องค์การ	z o ng^ k aa n^ 
องค์ประกอบ	z o ng^ pr a k @@ p^ 
อด	z o t^ 
อดกลั้น	z o t^ kl a n^ 
อดทน	z o t^ th o n^ 
อดอยาก	z o t^ j aa k^ 
อดิเรกสาร	z a d i r ee k^ s aa n^ 
อดีต	z a d ii t^ 
อธิการบดี	z a th i k aa n^ b @@ d ii 
อธิบดี	z a th i p^ b @@ d ii 
อธิบาย	z a th i b aa j^ 
อธิปัตย์	z a th i p a t^ 
อธิปไตย	z a th i p^ p a t a j^ 
อธิษฐาน	z a th i t^ th aa n^ 
อนัตตา	z a n a t^ t aa 
อนาคต	z a n aa kh o t^ 
อนามัย	z a n aa m a j^ 
อนิจจัง	z a n i t^ c a ng^ 
อนึ่ง	z a n v ng^ 
อนุญาต	z a n u j aa t^ 
อนุบาล	z a n u b aa n^ 
อนุพากย์	z a n u ph aa k^ 
อนุมัติ	z a n u m a t^ 
อนุมาน	z a n u m aa n^ 
อนุมาน	z a n u m aa n^ 
อนุมานราชธน	z a n u m aa n^ r aa t^ ch a th o n^ 
อนุรักษ์	z a n u r a k^ 
อนุสรณ์	z a n u s @@ n^ 
อนุโลม	z a n u l oo m^ 
อบรม	z o p^ r o m^ 
อบอุ่น	z o p^ z u n^ 
อพยพ	z o p^ ph a j o p^ 
อภัย	z a ph a j^ 
อภัยทาน	z a ph a j^ j a th aa n^ 
อภัยธรรม	z a ph a j^ j a th a m^ 
อภัยวงศ์	z a ph a j^ w o ng^ 
อภิปราย	z a ph i pr aa j^ 
อม	z o m^ 
อมรวิวัฒน์	z a m @@ n^ w i w a t^ 
อมเรศ	z a m a r ee t^ 
อยาก	j aa k^ 
อยุติธรรม	z a j u t^ t i th a m^ 
อยู่	j uu 
อยู่ดี	j uu d ii 
อยู่ตัว	j uu t uua 
อยู่บำรุง	j uu b a m^ r u ng^ 
อยู่รอด	j uu r @@ t^ 
อย่า	j aa 
อย่าง	j aa ng^ 
อย่างยิ่ง	j aa ng^ j i ng^ 
อย่างหนึ่ง	j aa ng^ n v ng^ 
อย่างเช่น	j aa ng^ ch e n^ 
อย่างเดียว	j aa ng^ d iia w^ 
อย่างใด	j aa ng^ d a j^ 
อย่างไร	j aa ng^ r a j^ 
อย่างไรก็ดี	j aa ng^ r a j^ k @@ d ii 
อย่างไรก็ตาม	j aa ng^ r a j^ k @@ t aa m^ 
อรหันต์	z @@ r a h a n^ 
อริยบุคคล	z a r i j a b u k^ kh o n^ 
อริยสัจ	z a r i j a s a t^ 
อวัยวะ	z a w a j^ j a w a 
ออก	z @@ k^ 
ออกกำลัง	z @@ k^ k a m^ l a ng^ 
ออกกำลังกาย	z @@ k^ k a m^ l a ng^ k aa j^ 
ออกแบบ	z @@ k^ b xx p^ 
ออฟโฟร์	z @@ f^ f oo 
ออม	z @@ m^ 
ออมชอม	z @@ m^ ch @@ m^ 
อะตอม	z a t @ m^ 
อะไร	z a r a j^ 
อักษร	z a k^ s @@ n^ 
อักษรศาสตร์	z a k^ s @@ n^ s aa t^ 
อักษะ	z a k^ s a 
อักเสบ	z a k^ s ee p^ 
อังกฤษ	z a ng^ kr i t^ 
อังคาร	z a ng^ kh aa n^ 
อัจฉริยภาพ	z a t^ ch a r i j a ph aa p^ 
อัจฉริยะ	z a t^ ch a r i j a 
อัญชัน	z a n^ ch a n^ 
อัญมณี	z a n^ j a m a n ii 
อัด	z a t^ 
อัตตาธิปไตย	z a t^ t aa th i p^ p a t a j^ 
อัตภาพ	z a t^ t a ph aa p^ 
อัตรา	z a t^ tr aa 
อัตราส่วน	z a t^ tr aa s uua n^ 
อัตลักษณ์	z a t^ t a l a k^ 
อัตโนมัติ	z a t^ t a n oo m a t^ 
อัน	z a n^ 
อันดับ	z a n^ d a p^ 
อันตราย	z a n^ t a r aa j^ 
อันที่จริง	z a n^ th ii c i ng^ 
อันหนึ่ง	z a n^ n v ng^ 
อันหนึ่งอันเดียวกัน	z a n^ n v ng^ z a n^ d iia w^ k a n^ 
อันเดียว	z a n^ d iia w^ 
อันเดียวกัน	z a n^ d iia w^ k a n^ 
อันเนื่องมาจาก	z a n^ n vva ng^ m aa c aa k^ 
อับอาย	z a p^ z aa j^ 
อัปมงคล	z a p^ p a m o ng^ kh o n^ 
อัปยศ	z a p^ p a j o t^ 
อัลคาโปน	z a n^ kh aa p oo n^ 
อัศจรรย์	z a t^ s a c a n^ 
อา	z aa 
อากร	z aa k @@ n^ 
อาการ	z aa k aa n^ 
อาการนาม	z aa k aa n^ r a n aa m^ 
อากาศ	z aa k aa t^ 
อาคาร	z aa kh aa n^ 
อาคเนย์	z aa kh a n ee 
อาจ	z aa t^ 
อาจารย์	z aa c aa n^ 
อาชญากร	z aa t^ j aa k @@ n^ 
อาชญากรรม	z aa t^ ch a j aa k a m^ 
อาชญากรรม	z aa t^ j aa k a m^ 
อาชีพ	z aa ch ii p^ 
อาณัติ	z aa n a t^ 
อาณาจักร	z aa n aa c a k^ 
อาณานิคม	z aa n aa n i kh o m^ 
อาณาเขต	z aa n aa kh ee t^ 
อาตมา	z aa t^ t a m aa 
อาทร	z aa th @@ n^ 
อาทิ	z aa th i 
อาทิตย์	z aa th i t^ 
อานันท์	z aa n a n^ 
อาบน้ำ	z aa p^ n aa m^ 
อามิสทาน	z aa m i t^ s a th aa n^ 
อาย	z aa j^ 
อายตนะ	z aa j a t a n a 
อายัด	z aa j a t^ 
อายุ	z aa j u 
อายุขัย	z aa j u kh a j^ 
อารมณ์	z aa r o m^ 
อารยชน	z aa r a j a ch o n^ 
อารยธรรม	z aa r a j a th a m^ 
อาร์ตติสท์	z aa t^ t i s^ 
อาวุธ	z aa w u t^ 
อาวุโส	z aa w u s oo 
อาศัย	z aa s a j^ 
อาสา	z aa s aa 
อาสาสมัคร	z aa s aa s a m a k^ 
อาหว่า	z aa w aa 
อาหาร	z aa h aa n^ 
อาเซียน	z aa s iia n^ 
อำนวย	z a m^ n uua j^ 
อำนวยการ	z a m^ n uua j^ k aa n^ 
อำนาจ	z a m^ n aa t^ 
อำเภอ	z a m^ ph qq 
อิจฉา	z i t^ ch aa 
อิตาเลียน	z i t aa l iia n^ 
อิทธิพล	z i t^ th i ph o n^ 
อินเดีย	z i n^ d iia 
อินโดจีน	z i n^ d oo c ii n^ 
อินโดนีเซีย	z i n^ d oo n ii s iia 
อิรัก	z i r a k^ 
อิลิช	z i l i ch^ 
อิสระ	z i t^ s a r a 
อิสลาม	z i s a l aa m^ 
อิเล็กทรอนิกส์	z i l e k^ thr @@ n i k^ 
อิ่ม	z i m^ 
อีก	z ii k^ 
อีรี่	z ii r ii 
อีวาน	z ii w aa n^ 
อีสาน	z ii s aa n^ 
อึดอัด	z v t^ z a t^ 
อื่น	z vv n^ 
อื้อฉาว	z vv ch aa w^ 
อุณหภูมิ	z u n^ h a ph uu m^ 
อุดตัน	z u t^ t a n^ 
อุดม	z u d o m^ 
อุดมการณ์	z u d o m^ k aa n^ 
อุดมศึกษา	z u t^ d o m^ m a s v k^ s aa 
อุดมศึกษา	z u d o m^ m a s v k^ s aa 
อุดมศึกษา	z u d o m^ s v k^ s aa 
อุดมสมบูรณ์	z u d o m^ s o m^ b uu n^ 
อุดร	z u d @@ n^ 
อุดรธานี	z u d @@ n^ th aa n ii 
อุตสาหกรรม	z u t^ s aa h a k a m^ 
อุตสาหะ	z u t^ s aa h a 
อุทยาน	z u t^ th a j aa n^ 
อุทัย	z u th a j^ 
อุทาหรณ์	z u th aa h @@ n^ 
อุทิศ	z u th i t^ 
อุบัติเหตุ	z u b a t^ t i h ee t^ 
อุปกรณ์	z u p^ p a k @@ n^ 
อุปนิสัย	z u p^ p a n i s a j^ 
อุปสรรค	z u p^ p a s a k^ 
อุปโภค	z u p^ p a ph oo k^ 
อเนกชน	z a n ee k^ ch o n^ 
อเมริกัน	z a m ee r i k a n^ 
อเมริกา	z a m ee r i k aa 
อเล็กซานเดรีย	z a l e k^ s aa n^ dr iia 
อโลชา	z a l oo ch aa 
อโศก	z a s oo k^ 
อ่อน	z @@ n^ 
อ่อนหวาน	z @@ n^ w aa n^ 
อ่อนแอ	z @@ n^ z xx 
อ่อนโยน	z @@ n^ j oo n^ 
อ่าง	z aa ng^ 
อ่าน	z aa n^ 
อ่าว	z aa w^ 
อ้วน	z uua n^ 
อ้อม	z @@ m^ 
อ้าง	z aa ng^ 
อ้างอิง	z aa ng^ z i ng^ 
อ้าย	z aa j^ 
ฮอร์โมน	h @@ m oo n^ 
ฮินดู	h i n^ d uu 
ฮุสเซ็น	h u t^ s e n^ 
ฯพณฯ	ph a n a th a n^ 
เกณฑ์	k ee n^ 
เกรง	kr ee ng^ 
เกรงขาม	kr ee ng^ kh aa m^ 
เกรงอกเกรงใจ	kr ee ng^ z o k^ kr ee ng^ c a j^ 
เกรงใจ	kr ee ng^ c a j^ 
เกริกเกียรติ	kr qq k^ k iia t^ 
เกรียวกราว	kr iia w^ kr aa w^ 
เกลียด	kl iia t^ 
เกลียดชัง	kl iia t^ ch a ng^ 
เกลื่อนกลาด	kl vva n^ kl aa t^ 
เกษตร	k a s ee t^ 
เกษตรกร	k a s ee t^ tr a k @@ n^ 
เกษตรกรรม	k a s ee t^ tr a k a m^ 
เกษียณ	k a s iia n^ 
เกาหลีเหนือ	k a w^ l ii n vva 
เกาหลีใต้	k a w^ l ii t a j^ 
เกาะ	k @ 
เกิด	k qq t^ 
เกิน	k qq n^ 
เกียรติ	k iia t^ 
เกียรติภูมิ	k iia t^ t i ph uu m^ 
เกียรติยศ	k iia t^ t i j o t^ 
เกี่ยว	k iia w^ 
เกี่ยวกับ	k iia w^ k a p^ 
เกี่ยวข้อง	k iia w^ kh @ ng^ 
เกี่ยวข้อง	k iia w^ kh @@ ng^ 
เกี่ยวพัน	k iia w^ ph a n^ 
เกี่ยวเนื่อง	k iia w^ n vva ng^ 
เกี่ยวโยง	k iia w^ j oo ng^ 
เกือบ	k vva p^ 
เกือบจะ	k vva p^ c a 
เกื้อกูล	k vva k uu n^ 
เกื้อหนุน	k vva n u n^ 
เก็บ	k e p^ 
เก่ง	k e ng^ 
เก่า	k a w^ 
เก่าแก่	k a w^ k xx 
เก้า	k a w^ 
เก้า	k aa w^ 
เก้าอี้	k a w^ z ii 
เขต	kh ee t^ 
เขมร	kh a m ee n^ 
เขย	kh qq j^ 
เขยิบ	kh a j q p^ 
เขลา	khl a w^ 
เขา	kh a w^ 
เขียง	kh iia ng^ 
เขียน	kh iia n^ 
เขียว	kh iia w^ 
เขื่อน	kh vva n^ 
เข็มฉีดยา	kh e m^ ch ii t^ j aa 
เข่นฆ่า	kh e n^ kh aa 
เข้มข้น	kh e m^ kh o n^ 
เข้มงวด	kh e m^ ng uua t^ 
เข้มแข็ง	kh e m^ kh x ng^ 
เข้า	kh a w^ 
เข้าใจ	kh a w^ c a j^ 
เคมี	kh ee m ii 
เคย	kh qq j^ 
เครดิต	khr ee d i t^ 
เครมลิน	khr ee m^ l i n^ 
เคราะห์กรรม	khr @ k a m^ 
เครียด	khr iia t^ 
เครือ	khr vva 
เครือข่าย	khr vva kh aa j^ 
เครื่อง	khr vva ng^ 
เครื่องจักร	khr vva ng^ c a k^ 
เครื่องจักสาน	khr vva ng^ c a k^ s aa n^ 
เครื่องช่วย	khr vva ng^ ch uua j^ 
เครื่องดนตรี	khr vva ng^ d o n^ tr ii 
เครื่องนุ่งห่ม	khr vva ng^ n u ng^ h o m^ 
เครื่องปั้นดินเผา	khr vva ng^ p a n^ d i n^ ph a w^ 
เครื่องมือ	khr vva ng^ m vv 
เครื่องหมาย	khr vva ng^ m aa j^ 
เครื่องเทศ	khr vva ng^ th ee t^ 
เครื่องใช้	khr vva ng^ ch a j^ 
เครื่องไม้	khr vva ng^ m aa j^ 
เคร่งครัด	khr e ng^ khr a t^ 
เคร่งเครียด	khr e ng^ khr iia t^ 
เคลลี่	kh e n^ l ii 
เคลื่อน	khl vva n^ 
เคลื่อนที่	khl vva n^ th ii 
เคลื่อนย้าย	khl vva n^ j aa j^ 
เคลื่อนไหว	khl vva n^ w a j^ 
เคารพ	kh a w^ r o p^ 
เคาะ	kh @ 
เคียงข้าง	kh iia ng^ kh aa ng^ 
เคียดแค้น	kh iia t^ kh xx n^ 
เค้า	kh a w^ 
เงา	ng a w^ 
เงาะ	ng @ 
เงิน	ng q n^ 
เงิน	ng qq n^ 
เงินตรา	ng q n^ tr aa 
เงินเดือน	ng qq n^ d vva n^ 
เงียบ	ng iia p^ 
เงียบเหงา	ng iia p^ ng a w^ 
เงื่อนปม	ng vva n^ p o m^ 
เงื่อนไข	ng vva n^ kh a j^ 
เจดีย์	c ee d ii 
เจตคติ	c ee t a kh a t i 
เจตจำนง	c ee t^ c a m^ n o ng^ 
เจตนา	c ee t^ t a n aa 
เจตนารมณ์	c ee t^ t a n aa r o m^ 
เจตภูต	c ee t^ t a ph uu t^ 
เจนจัด	c ee n^ c a t^ 
เจรจา	c ee r a c aa 
เจริญ	c a r qq n^ 
เจาะจง	c @ c o ng^ 
เจียงไคเช็ก	c iia ng^ kh a j^ ch e k^ 
เจ็ด	c e t^ 
เจ็บ	c e p^ 
เจ็บปวด	c e p^ p uua t^ 
เจ็บป่วย	c e p^ p uua j^ 
เจ็บแค้น	c e p^ kh xx n^ 
เจ็บไข้ได้ป่วย	c e p^ kh a j^ d aa j^ p uua j^ 
เจ้า	c a w^ 
เจ้ากรม	c a w^ kr o m^ 
เจ้าของ	c a w^ kh @@ ng^ 
เจ้าคณะ	c aa w^ kh a n a 
เจ้าคุณ	c a w^ kh u n^ 
เจ้าตัว	c a w^ t uua 
เจ้านาย	c a w^ n aa j^ 
เจ้าพนักงาน	c a w^ ph a n a k^ ng aa n^ 
เจ้าพระยา	c a w^ phr a j aa 
เจ้าพระยา	c aa w^ phr a j aa 
เจ้าพ่อ	c a w^ ph @@ 
เจ้าฟ้า	c a w^ f aa 
เจ้าฟ้า	c aa w^ f aa 
เจ้าภาพ	c aa w^ ph aa p^ 
เจ้าระเบียบ	c aa w^ r a b iia p^ 
เจ้าวัด	c aa w^ w a t^ 
เจ้าหน้าที่	c a w^ n aa th ii 
เจ้าอยู่หัว	c a w^ j uu h uua 
เจ้าอยู่หัว	c aa w^ j uu h uua 
เฉพาะ	ch a ph @ 
เฉพาะกาล	ch a ph @ k aa n^ 
เฉพาะตัว	ch a ph @ t uua 
เฉพาะที่	ch a ph @ th ii 
เฉพาะหน้า	ch a ph @ n aa 
เฉย	ch qq j^ 
เฉลิม	ch a l qq m^ 
เฉลิมฉลอง	ch a l qq m^ ch a l @@ ng^ 
เฉลิมพระชนมพรรษา	ch a l qq m^ phr a ch o n^ m a ph a n^ s aa 
เฉลียวฉลาด	ch a l iia w^ ch a l aa t^ 
เฉลี่ย	ch a l iia 
เฉียบพลัน	ch iia p^ phl a n^ 
เชคโกสโลวเกีย	ch e k^ k oo s a l oo w a k iia 
เชลย	ch a l qq j^ 
เชาวน์ปัญญา	ch a w^ p a n^ j aa 
เชิง	ch qq ng^ 
เชิญ	ch qq n^ 
เชิญชวน	ch qq n^ ch uua n^ 
เชียงใหม่	ch iia ng^ m a j^ 
เชี่ยวชาญ	ch iia w^ ch aa n^ 
เชื่อ	ch vva 
เชื่องช้า	ch vva ng^ ch aa 
เชื่อถือ	ch vva th vv 
เชื่อฟัง	ch vva f a ng^ 
เชื่อม	ch vva m^ 
เชื่อมต่อ	ch vva m^ t @@ 
เชื่อมั่น	ch vva m a n^ 
เชื่อมโยง	ch vva m^ j oo ng^ 
เชื้อ	ch vva 
เชื้อชาติ	ch vva ch aa t^ 
เชื้อบ้า	ch vva b aa 
เชื้อสาย	ch vva s aa j^ 
เชื้อเพลิง	ch vva phl qq ng^ 
เชื้อโรค	ch vva r oo k^ 
เช่น	ch e n^ 
เช่นกัน	ch e n^ k a n^ 
เช่นนั้น	ch e n^ n a n^ 
เช่นนี้	ch e n^ n ii 
เช่นเดียว	ch e n^ d iia w^ 
เช่นเดียวกัน	ch e n^ d iia w^ k a n^ 
เช่นเดียวกับ	ch e n^ d iia w^ k a p^ 
เช่นไร	ch e n^ r a j^ 
เช่า	ch a w^ 
เช้า	ch aa w^ 
เช้ามืด	ch aa w^ m vv t^ 
เซลล์	s ee w^ 
เซียมซี	s iia m^ s ii 
เซ็กส์	s e k^ 
เซ็น	s e n^ 
เซ็นทรัล	s e n^ thr a n^ 
เดอะ	d q 
เดอะบอสส์	d q b @@ s^ 
เดา	d a w^ 
เดิน	d qq n^ 
เดินทาง	d qq n^ th aa ng^ 
เดิม	d qq m^ 
เดียรัจฉาน	d iia r a t^ ch aa n^ 
เดียว	d iia w^ 
เดียวกัน	d iia w^ k a n^ 
เดียวกับ	d iia w^ k a p^ 
เดี่ยว	d iia w^ 
เดี๋ยวนี้	d iia w^ n ii 
เดือดร้อน	d vva t^ r @@ n^ 
เดือน	d vva n^ 
เด็ก	d e k^ 
เด็กสาว	d e k^ s aa w^ 
เด็กหญิง	d e k^ j i ng^ 
เด็กหนุ่ม	d e k^ n u m^ 
เด็ดขาด	d e t^ kh aa t^ 
เด็ดเดี่ยว	d e t^ d iia w^ 
เด่น	d e n^ 
เตมียเวส	t ee m ii j a w ee t^ 
เตรียม	tr iia m^ 
เตรียมพร้อม	tr iia m^ phr @@ m^ 
เตา	t a w^ 
เติบโต	t qq p^ t oo 
เติม	t qq m^ 
เตียง	t iia ng^ 
เตี่ย	t iia 
เตือน	t vva n^ 
เต็ม	t e m^ 
เต็มที่	t e m^ th ii 
เต็มเปี่ยม	t e m^ p iia m^ 
เต็มใจ	t e m^ c a j^ 
เต็มไปด้วย	t e m^ p a j^ d uua j^ 
เต่า	t a w^ 
เต้น	t e n^ 
เถาทอง	th a w^ th @@ ng^ 
เถิด	th qq t^ 
เถียง	th iia ng^ 
เถื่อน	th vva n^ 
เทคนิค	th e k^ n i k^ 
เทคนิค	th ee k^ n i k^ 
เทคโนโลยี	th e k^ n oo l oo j ii 
เทป	th ee p^ 
เทวดา	th ee w a d aa 
เทศกาล	th ee t^ s a k aa n^ 
เทศนา	th ee t^ s a n aa 
เทศน์	th ee t^ 
เทอร์มินัล	th qq m i n a n^ 
เทียน	th iia n^ 
เทียนชัย	th iia n^ ch a j^ 
เทียบ	th iia p^ 
เทียบเคียง	th iia p^ kh iia ng^ 
เทียม	th iia m^ 
เที่ยง	th iia ng^ 
เที่ยงธรรม	th iia ng^ th a m^ 
เที่ยว	th iia w^ 
เที่ยวเตร่	th iia w^ tr ee 
เทเวศร์วงศ์วิวัฒน์	th ee w ee t^ w o ng^ w i w a t^ 
เท็จ	th e t^ 
เท่า	th a w^ 
เท่านั้น	th a w^ n a n^ 
เท่าเทียม	th a w^ th iia m^ 
เท่าใด	th a w^ d a j^ 
เท่าไหร่	th a w^ r a j^ 
เท้า	th a w^ 
เท้า	th aa w^ 
เธอ	th qq 
เนรเทศ	n ee r a th ee t^ 
เนิน	n qq n^ 
เนือง	n vva ng^ 
เนืองแน่น	n vva ng^ n xx n^ 
เนื่อง	n vva ng^ 
เนื่องจาก	n vva ng^ c aa k^ 
เนื่องด้วย	n vva ng^ d uua j^ 
เนื่องมาจาก	n vva ng^ m aa c aa k^ 
เนื้อ	n vva 
เนื้อความ	n vva khw aa m^ 
เนื้อที่	n vva th ii 
เนื้อหา	n vva h aa 
เนื้อเยื่อ	n vva j vva 
เนื้อเรื่อง	n vva r vva ng^ 
เนื้อแท้	n vva th xx 
เนเธอร์แลนด์	n ee th qq l xx n^ 
เน้น	n e n^ 
เน้นหนัก	n e n^ n a k^ 
เบญจขันธ์	b e n^ c a kh a n^ 
เบรก	br ee k^ 
เบสิก	b ee s i k^ 
เบอร์	b qq 
เบา	b a w^ 
เบาบาง	b a w^ b aa ng^ 
เบิก	b qq k^ 
เบียดเบียน	b iia t^ b iia n^ 
เบี่ยงเบน	b iia ng^ b ee n^ 
เบี้ย	b iia 
เบื่อหน่าย	b vva n aa j^ 
เบื้อง	b vva ng^ 
เบื้องต้น	b vva ng^ t o n^ 
เบื้องหลัง	b vva ng^ l a ng^ 
เบื้องแรก	b vva ng^ r xx k^ 
เบ็ดเสร็จ	b e t^ s e t^ 
เบ่งบาน	b e ng^ b aa n^ 
เปรม	pr ee m^ 
เปรียญ	p a r iia n^ 
เปรียบ	pr iia p^ 
เปรียบเทียบ	pr iia p^ th iia p^ 
เปลี่ยน	pl iia n^ 
เปลี่ยนแปลง	pl iia n^ pl xx ng^ 
เปลือก	pl vva k^ 
เปลือง	pl vva ng^ 
เปล่ง	pl e ng^ 
เปล่า	pl aa w^ 
เปอร์เซีย	p qq s iia 
เปอร์เซ็นต์	p qq s e n^ 
เปิด	p qq t^ 
เปิดเผย	p qq t^ ph qq j^ 
เปิดโปง	p qq t^ p oo ng^ 
เปียโน	p iia n oo 
เป็น	p e n^ 
เป็นจริง	p e n^ c i ng^ 
เป็นตัวเป็นตน	p e n^ t uua p e n^ t o n^ 
เป็นต้น	p e n^ t o n^ 
เป็นต้นไป	p e n^ t o n^ p a j^ 
เป็นธรรม	p e n^ th a m^ 
เป็นมา	p e n^ m aa 
เป็นล่ำเป็นสัน	p e n^ l a m^ p e n^ s a n^ 
เป็นสุข	p e n^ s u k^ 
เป็นห่วง	p e n^ h uua ng^ 
เป็นอยู่	p e n^ j uu 
เป็นอันขาด	p e n^ z a n^ kh aa t^ 
เป็นอันมาก	p e n^ z a n^ m aa k^ 
เป็นเลิศ	p e n^ l qq t^ 
เป็นแน่	p e n^ n xx 
เป็นใหญ่	p e n^ j a j^ 
เป้า	p a w^ 
เป้าประสงค์	p a w^ pr a s o ng^ 
เป้าหมาย	p a w^ m aa j^ 
เป๊าะ	p @ 
เผชิญ	ph a ch qq n^ 
เผชิญหน้า	ph a ch qq n^ n aa 
เผด็จการ	ph a d e t^ k aa n^ 
เผย	ph qq j^ 
เผยแพร่	ph qq j^ phr xx 
เผอิญ	ph a z qq n^ 
เผื่อ	ph vva 
เผ่า	ph a w^ 
เผ่าพันธุ์	ph a w^ ph a n^ 
เฝ้า	f a w^ 
เพชร	ph e t^ 
เพราะ	phr @ 
เพราะฉะนั้น	phr @ ch a n a n^ 
เพราะว่า	phr @ w aa 
เพลง	phl ee ng^ 
เพลิง	phl qq ng^ 
เพลิดเพลิน	phl qq t^ phl qq n^ 
เพศ	ph ee t^ 
เพศสัมพันธ์	ph ee t^ s a m^ ph a n^ 
เพาะ	ph @ 
เพาะปลูก	ph @ pl uu k^ 
เพาะเลี้ยง	ph @ l iia ng^ 
เพิกถอน	ph qq k^ th @@ n^ 
เพิกเฉย	ph qq k^ ch qq j^ 
เพิ่ง	ph q ng^ 
เพิ่ม	ph q m^ 
เพิ่ม	ph qq m^ 
เพิ่มพูน	ph qq m^ ph uu n^ 
เพิ่มเติม	ph qq m^ t qq m^ 
เพียง	ph iia ng^ 
เพียงนี้	ph iia ng^ n ii 
เพียงพอ	ph iia ng^ ph @@ 
เพียงแค่	ph iia ng^ kh xx 
เพียงแต่	ph iia ng^ t xx 
เพียงใด	ph iia ng^ d a j^ 
เพียงไร	ph iia ng^ r a j^ 
เพื่อ	ph vva 
เพื่อที่จะ	ph vva th ii c a 
เพื่อน	ph vva n^ 
เพื่อนบ้าน	ph vva n^ b aa n^ 
เพื่อนฝูง	ph vva n^ f uu ng^ 
เพื่อให้	ph vva h a j^ 
เพ่ง	ph e ng^ 
เพ่งเล็ง	ph e ng^ l e ng^ 
เพ่นพ่าน	ph e n^ ph aa n^ 
เพ้อฝัน	ph qq f a n^ 
เฟโดรอฟ	f ee d oo r @@ f^ 
เมดิเตอร์เรเนียน	m ee d i t qq r ee n iia n^ 
เมตตา	m ee t^ t aa 
เมตตาธรรม	m ee t^ t aa th a m^ 
เมตร	m ee t^ 
เมษ	m ee t^ 
เมษายน	m ee s aa j o n^ 
เมา	m a w^ 
เมามาย	m a w^ m aa j^ 
เมีย	m iia 
เมียด	m iia t^ 
เมียน้อย	m iia n @@ j^ 
เมียหลวง	m iia l uua ng^ 
เมือง	m vva ng^ 
เมืองนอก	m vva ng^ n @@ k^ 
เมืองหลวง	m vva ng^ l uua ng^ 
เมื่อ	m vva 
เมื่อกี้	m vva k ii 
เมื่อก่อน	m vva k @@ n^ 
เมื่อครั้ง	m vva khr a ng^ 
เมื่อใด	m vva d a j^ 
เมื่อไร	m vva r a j^ 
เม็กซิกัน	m e k^ s i k a n^ 
เม็กซิโก	m e k^ s i k oo 
เม็ด	m e t^ 
เยลต์ซิน	j ee w^ s i n^ 
เยอรมนี	j qq r a m a n ii 
เยอรมัน	j qq r a m a n^ 
เยอะ	j q 
เยอะแยะ	j q j x 
เยาวชน	j a w^ w a ch o n^ 
เยาว์	j a w^ 
เยาว์วัย	j a w^ w a j^ 
เยาะเย้ย	j @ j qq j^ 
เยียวยา	j iia w^ j aa 
เยี่ยม	j iia m^ 
เยือกเย็น	j vva k^ j e n^ 
เยือน	j vva n^ 
เยื่อ	j vva 
เย็น	j e n^ 
เรา	r a w^ 
เริ่ม	r qq m^ 
เริ่มต้น	r qq m^ t o n^ 
เรียก	r iia k^ 
เรียกร้อง	r iia k^ r @@ ng^ 
เรียง	r iia ng^ 
เรียงความ	r iia ng^ khw aa m^ 
เรียน	r iia n^ 
เรียนรู้	r iia n^ r uu 
เรียบ	r iia p^ 
เรียบร้อย	r iia p^ r @@ j^ 
เรียบเรียง	r iia p^ r iia ng^ 
เรือ	r vva 
เรือน	r vva n^ 
เรือนจำ	r vva n^ c a m^ 
เรื่อง	r vva ng^ 
เรื่องราว	r vva ng^ r aa w^ 
เรื่องสั้น	r vva ng^ s a n^ 
เรื่อย	r vva j^ 
เรื้อรัง	r vva r a ng^ 
เร็ว	r e w^ 
เร่ง	r e ng^ 
เร่งด่วน	r e ng^ d uua n^ 
เร่งรัด	r e ng^ r a t^ 
เร่งรีบ	r e ng^ r ii p^ 
เร่งเร้า	r e ng^ r a w^ 
เร่ร่อน	r ee r @ n^ 
เร้น	r e n^ 
เร้า	r a w^ 
เลข	l ee k^ 
เลขที่	l ee k^ th ii 
เลขหมาย	l ee k^ m aa j^ 
เลขาธิการ	l ee kh aa th i k aa n^ 
เลขานุการ	l ee kh aa n u k aa n^ 
เลย	l qq j^ 
เลว	l ee w^ 
เลวร้าย	l ee w^ r aa j^ 
เลวิน	l ee w i n^ 
เลิก	l qq k^ 
เลิกรา	l qq k^ r aa 
เลิศเลอ	l qq t^ l qq 
เลียน	l iia n^ 
เลี่ยง	l iia ng^ 
เลี้ยง	l iia ng^ 
เลี้ยงดู	l iia ng^ d uu 
เลือก	l vva k^ 
เลือกตั้ง	l vva k^ t a ng^ 
เลือกสรร	l vva k^ s a n^ 
เลือด	l vva t^ 
เลือดเนื้อ	l vva t^ n vva 
เลือน	l vva n^ 
เลื่อน	l vva n^ 
เลื่อนลอย	l vva n^ l @@ j^ 
เลื่อมใส	l vva m^ s a j^ 
เล็ก	l e k^ 
เล็กน้อย	l e k^ n @@ j^ 
เล็ง	l e ng^ 
เล็งเห็น	l e ng^ h e n^ 
เล่น	l e n^ 
เล่นงาน	l e n^ ng aa n^ 
เล่ม	l e m^ 
เล่า	l a w^ 
เล่าปี่	l a w^ p ii 
เล่าลือ	l a w^ l vv 
เล่าเรียน	l a w^ r iia n^ 
เล้ง	l e ng^ 
เวทมนตร์	w ee t^ m o n^ 
เวที	w ee th ii 
เวลา	w ee l aa 
เวสนันท์	w ee t^ s a n a n^ 
เวหา	w ee h aa 
เวิลด์โฟน	w qq w^ f oo n^ 
เวียงจันทน์	w iia ng^ c a n^ 
เวียดนาม	w iia t^ n aa m^ 
เว้น	w e n^ 
เว้นไว้แต่	w e n^ w a j^ t xx 
เศรษฐกิจ	s ee t^ th a k i t^ 
เศรษฐศาสตร์	s ee t^ th a s aa t^ 
เศรษฐี	s ee t^ th ii 
เศร้า	s a w^ 
เศร้าหมอง	s a w^ m @@ ng^ 
เศร้าโศก	s a w^ s oo k^ 
เสงี่ยม	s a ng iia m^ 
เสด็จ	s a d e t^ 
เสถียรภาพ	s a th iia n^ r a ph aa p^ 
เสนอ	s a n qq 
เสนอแนะ	s a n qq n x 
เสนาธิการ	s ee n aa th i k aa n^ 
เสนาะ	s a n @ 
เสน่ห์	s a n ee 
เสพ	s ee p^ 
เสมอ	s a m qq 
เสมอภาค	s a m qq ph aa k^ 
เสมือน	s a m vva n^ 
เสริม	s qq m^ 
เสรี	s ee r ii 
เสรีภาพ	s ee r ii ph aa p^ 
เสรีไทย	s ee r ii th a j^ 
เสร็จ	s e t^ 
เสร็จสิ้น	s e t^ s i n^ 
เสวนา	s e w a n aa 
เสาร์	s a w^ 
เสีย	s iia 
เสียก่อน	s iia k @@ n^ 
เสียง	s iia ng^ 
เสียดาย	s iia d aa j^ 
เสียที	s iia th ii 
เสียวเหา	s iia w^ h a w^ 
เสียสละ	s iia s a l a 
เสียหาย	s iia h aa j^ 
เสียเปรียบ	s iia pr iia p^ 
เสียแล้ว	s iia l xx w^ 
เสียใจ	s iia c a j^ 
เสี่ย	s iia 
เสี่ยง	s iia ng^ 
เสือ	s vva 
เสื่อม	s vva m^ 
เสื่อมถอย	s vva m^ th @ j^ 
เสื่อมถอย	s vva m^ th @@ j^ 
เสื่อมโทรม	s vva m^ s oo m^ 
เสื้อ	s vva 
เสื้อผ้า	s vva ph aa 
เส้น	s e n^ 
เส้นทาง	s e n^ th aa ng^ 
เส้นสาย	s e n^ s aa j^ 
เหงา	ng a w^ 
เหตุ	h ee t^ 
เหตุการณ์	h ee t^ k aa n^ 
เหตุจูงใจ	h ee t^ c uu ng^ c a j^ 
เหตุผล	h ee t^ ph o n^ 
เหตุใด	h ee t^ d a j^ 
เหนียวแน่น	n iia w^ n x n^ 
เหนือ	n vva 
เหนื่อย	n vva j^ 
เหน็ดเหนื่อย	n e t^ n vva j^ 
เหมาะ	m @ 
เหมาะสม	m @ s o m^ 
เหมาเจ๋อตุง	m a w^ c qq t u ng^ 
เหมือน	m vva n^ 
เหมือนว่า	m vva n^ w aa 
เหม็น	m e n^ 
เหยียดหยาม	j iia t^ j aa m^ 
เหยื่อ	j vva 
เหรอ	r qq 
เหรียญ	r iia n^ 
เหลวแหลก	l ee w^ l xx k^ 
เหลียวแล	l iia w^ l xx 
เหลี่ยม	l iia m^ 
เหลือ	l vva 
เหลือง	l vva ng^ 
เหลือเกิน	l vva k qq n^ 
เหล่า	l a w^ 
เหล่าทัพ	l a w^ th a p^ 
เหล่านั้น	l a w^ n a n^ 
เหล่านี้	l a w^ n ii 
เหล้า	l a w^ 
เหา	h a w^ 
เหาะ	h @ 
เหี้ย	h iia 
เห็น	h e n^ 
เห็นด้วย	h e n^ d uua j^ 
เห็นพ้อง	h e n^ ph @@ ng^ 
เห็นอกเห็นใจ	h e n^ z o k^ h e n^ c a j^ 
เห็นแก่	h e n^ k xx 
เห็นได้	h e n^ d aa j^ 
เห็นได้ว่า	h e n^ d aa j^ w aa 
เอ	z ee 
เอก	z ee k^ 
เอกฉันท์	z ee k^ k a ch a n^ 
เอกชน	z ee k^ k a ch o n^ 
เอกภาพ	z ee k^ k a ph aa p^ 
เอกราช	z ee k^ k a r aa t^ 
เอกลักษณะ	z ee k^ k a l a k^ s a n a 
เอกลักษณ์	z ee k^ k a l a k^ 
เอกสาร	z ee k^ k a s aa n^ 
เอกสารสิทธิ์	z ee k^ k a s aa n^ s i t^ 
เอง	z ee ng^ 
เองเกลส์	z e ng^ k ee w^ 
เองเกลส์	z ee ng^ k ee l^ 
เองเกลส์	z ee ng^ k ee w^ 
เอดส์	z ee t^ 
เอนเอียง	z ee n^ z iia ng^ 
เอา	z a w^ 
เอาจริงเอาจัง	z a w^ c i ng^ z a w^ c a ng^ 
เอาชนะ	z a w^ ch a n a 
เอารัดเอาเปรียบ	z a w^ r a t^ z a w^ pr iia p^ 
เอาอย่าง	z a w^ j aa ng^ 
เอาใจใส่	z a w^ c a j^ s a j^ 
เอียง	z iia ng^ 
เอื้อ	z vva 
เอื้ออำนวย	z vva z a m^ n uua j^ 
เอเชีย	z ee ch iia 
เอ็ด	z e t^ 
เอ็นดู	z e n^ d uu 
เอ่ย	z qq j^ 
เอ๊ะ	z e 
แก	k xx 
แกตต์	k x t^ 
แกนกลาง	k xx n^ kl aa ng^ 
แกลเลอรี่	k xx l^ l qq r ii 
แกะสลัก	k x s a l a k^ 
แก่	k xx 
แก่งแย่ง	k x ng^ j xx ng^ 
แก้	k xx 
แก้ตัว	k xx t uua 
แก้ว	k xx w^ 
แก้วหู	k xx w^ h uu 
แก้ไข	k xx kh a j^ 
แก๊ง	k x ng^ 
แก๊ง	k xx ng^ 
แก๊งสเตอร์	k x ng^ s a t qq 
แข	kh xx 
แขก	kh xx k^ 
แขน	kh xx n^ 
แขนง	kh a n xx ng^ 
แข็งกร้าว	kh x ng^ kr aa w^ 
แข็งขัน	kh x ng^ kh a n^ 
แข็งแกร่ง	kh x ng^ kr x ng^ 
แข็งแรง	kh x ng^ r xx ng^ 
แข่งขัน	kh x ng^ kh a n^ 
แข่งขัน	kh xx ng^ kh a n^ 
แข้ง	kh xx ng^ 
แคบ	kh xx p^ 
แคว้น	khw xx n^ 
แค่	kh xx 
แค้น	kh xx n^ 
แง่	ng xx 
แง่มุม	ng xx m u m^ 
แจก	c xx k^ 
แจกจ่าย	c xx k^ c aa j^ 
แจกแจง	c xx k^ c xx ng^ 
แจ่มแจ้ง	c x m^ c xx ng^ 
แจ้ง	c xx ng^ 
แดง	d xx ng^ 
แดด	d xx t^ 
แดน	d xx n^ 
แด่	d xx 
แตก	t xx k^ 
แตกต่าง	t xx k^ t aa ng^ 
แตกหัก	t xx k^ h a k^ 
แตกแยก	t xx k^ j xx k^ 
แตะ	t x 
แตะต้อง	t x t @ ng^ 
แต่	t xx 
แต่ก่อน	t xx k @@ n^ 
แต่ง	t x ng^ 
แต่ง	t xx ng^ 
แต่งงาน	t x ng^ ng aa n^ 
แต่งตัว	t xx ng^ t uua 
แต่งตั้ง	t x ng^ t a ng^ 
แต่งตั้ง	t xx ng^ t a ng^ 
แต่ประการใด	t xx pr a k aa n^ d a j^ 
แต่ละ	t xx l a 
แต่ว่า	t xx w aa 
แต่อย่างใด	t xx j aa ng^ d a j^ 
แต่เดิม	t xx d qq m^ 
แต่เพียง	t xx ph iia ng^ 
แถบ	th xx p^ 
แถลง	th a l xx ng^ 
แทง	th xx ng^ 
แทน	th xx n^ 
แทบ	th xx p^ 
แทรก	s xx k^ 
แทรกซึม	s xx k^ s v m^ 
แทรกแซง	s xx k^ s xx ng^ 
แท็กซี่	th x k^ s ii 
แท้	th xx 
แท้ง	th xx ng^ 
แท้จริง	th xx c i ng^ 
แท้ที่จริง	th xx th ii c i ng^ 
แนบแน่น	n xx p^ n x n^ 
แนว	n xx w^ 
แนวทาง	n xx w^ th aa ng^ 
แนวร่วม	n xx w^ r uua m^ 
แนวโน้ม	n xx w^ n oo m^ 
แนะ	n x 
แนะนำ	n x n a m^ 
แนะแนว	n x n xx w^ 
แน่	n xx 
แน่ชัด	n xx ch a t^ 
แน่น	n x n^ 
แน่นอน	n xx n @@ n^ 
แน่นแฟ้น	n x n^ f xx n^ 
แน่วแน่	n xx w^ n xx 
แน่ใจ	n xx c a j^ 
แบทเตน	b x t^ t e n^ 
แบน	b xx n^ 
แบบ	b xx p^ 
แบบจำลอง	b xx p^ c a m^ l @@ ng^ 
แบบฉบับ	b xx p^ ch a b a p^ 
แบบอย่าง	b xx p^ j aa ng^ 
แบบแผน	b xx p^ ph xx n^ 
แบ่ง	b x ng^ 
แบ่ง	b xx ng^ 
แบ่งปัน	b x ng^ p a n^ 
แบ่งแยก	b x ng^ j xx k^ 
แปง	p xx ng^ 
แปซิฟิก	p xx s i f i k^ 
แปด	p xx t^ 
แปร	pr xx 
แปรญัตติ	pr xx j a t^ t i 
แปรปรวน	pr xx pr uua n^ 
แปรผัน	pr xx ph a n^ 
แปล	pl xx 
แปลก	pl xx k^ 
แผน	ph xx n^ 
แผนการ	ph xx n^ k aa n^ 
แผนงาน	ph xx n^ ng aa n^ 
แผล	phl xx 
แผ่	ph xx 
แผ่นดิน	ph x n^ d i n^ 
แผ่นดิน	ph xx n^ d i n^ 
แฝง	f xx ng^ 
แพ	ph xx 
แพง	ph xx ng^ 
แพทย์	ph xx t^ 
แพร่	phr xx 
แพร่หลาย	phr xx l aa j^ 
แพะ	ph x 
แพ้	ph xx 
แฟน	f xx n^ 
แฟ้ม	f x m^ 
แมนฮัตตัน	m xx n^ h a t^ t a n^ 
แมลง	m a l xx ng^ 
แมว	m xx w^ 
แม่	m xx 
แม่ทัพ	m xx th a p^ 
แม่นยำ	m xx n^ j a m^ 
แม่น้ำ	m xx n aa m^ 
แม่บ้าน	m xx b aa n^ 
แม่เหล็ก	m xx l e k^ 
แม้	m xx 
แม้ว่า	m xx w aa 
แม้แต่	m xx t xx 
แยก	j xx k^ 
แยกตัว	j xx k^ t uua 
แยกแยะ	j xx k^ j x 
แย่	j xx 
แย่ง	j xx ng^ 
แย้ง	j xx ng^ 
แรก	r xx k^ 
แรกเกิด	r xx k^ k qq t^ 
แรกเริ่ม	r xx k^ r qq m^ 
แรง	r xx ng^ 
แรงกระตุ้น	r xx ng^ kr a t u n^ 
แรงกล้า	r xx ng^ kl aa 
แรงงาน	r xx ng^ ng aa n^ 
แรงจูงใจ	r xx ng^ c uu ng^ c a j^ 
แรงดัน	r xx ng^ d a n^ 
แรด	r xx t^ 
แลก	l xx k^ 
แลกเปลี่ยน	l xx k^ pl iia n^ 
และ	l x 
แล้ง	l xx ng^ 
แล้ว	l xx w^ 
แล้วมา	l xx w^ m aa 
แล้วแต่	l xx w^ t xx 
แวดล้อม	w xx t^ l @@ m^ 
แวดวง	w xx t^ w o ng^ 
แว่น	w xx n^ 
แสง	s xx ng^ 
แสดง	s a d xx ng^ 
แสน	s xx n^ 
แสลง	s a l xx ng^ 
แสวง	s a w xx ng^ 
แสวงหา	s a w xx ng^ h aa 
แหบ	h xx p^ 
แหลม	l xx m^ 
แหละ	l x 
แหล่ง	l x ng^ 
แหล่ง	l xx ng^ 
แหล่งข่าว	l xx ng^ kh aa w^ 
แห่	h xx 
แห่ง	h x ng^ 
แห่ง	h xx ng^ 
แห่งชาติ	h x ng^ ch aa t^ 
แห่งชาติ	h xx ng^ ch aa t^ 
แห้งแล้ง	h xx ng^ l xx ng^ 
แอบ	z xx p^ 
แอบแฝง	z xx p^ f xx ng^ 
แอฟริกัน	z x p^ fr i k a n^ 
แอมป์	z xx m^ 
แอร์	z xx 
แอสเซมบลี	z xx t^ s e m^ bl ii 
แออัด	z xx z a t^ 
แฮ	h xx 
โกรธ	kr oo t^ 
โกลน	kl oo n^ 
โกวิท	k oo w i t^ 
โขง	kh oo ng^ 
โคบอล	kh oo b @ l^ 
โคบอล	kh oo b @ n^ 
โคบอล	kh oo b @@ n^ 
โครง	khr oo ng^ 
โครงการ	khr oo ng^ k aa n^ 
โครงสร้าง	khr oo ng^ s aa ng^ 
โครงเรื่อง	khr oo ng^ r vva ng^ 
โควตา	kh oo t aa 
โควตา	khw oo t aa 
โค่น	kh oo n^ 
โง่	ng oo 
โจ	c oo 
โจมตี	c oo m^ t ii 
โจร	c oo n^ 
โจวเอินไหล	c oo w^ z qq n^ l a j^ 
โจฬะ	c oo l a 
โฉม	ch oo m^ 
โฉมหน้า	ch oo m^ n aa 
โชกโชน	ch oo k^ ch oo n^ 
โชค	ch oo k^ 
โชคดี	ch oo k^ d ii 
โซเวียต	s oo w iia t^ 
โดดเดี่ยว	d oo t^ d iia w^ 
โดดเด่น	d oo t^ d e n^ 
โดน	d oo n^ 
โดย	d oo j^ 
โดยมาก	d oo j^ m aa k^ 
โดยย่อ	d oo j^ j @@ 
โดยรวม	d oo j^ r uua m^ 
โดยเฉพาะ	d oo j^ ch a ph @ 
โดยเฉพาะอย่างยิ่ง	d oo j^ ch a ph @ j aa ng^ j i ng^ 
โดยเร็ว	d oo j^ r e w^ 
โต	t oo 
โตเกียว	t oo k iia w^ 
โต้	t oo 
โต้ตอบ	t oo t @@ p^ 
โต้แย้ง	t oo j xx ng^ 
โต๊ะ	t o 
โท	th oo 
โทรทัศน์	th oo r a th a t^ 
โทรศัพท์	th oo r a s a p^ 
โทษ	th oo t^ 
โนเบล	n oo b e w^ 
โน้น	n oo n^ 
โน้มน้าว	n oo m^ n aa w^ 
โน้มเอียง	n oo m^ z iia ng^ 
โบราณ	b oo r aa n^ 
โบราณกาล	b oo r aa n^ n a k aa n^ 
โบราณสถาน	b oo r aa n^ n a s a th aa n^ 
โปรดเกล้า	pr oo t^ kl aa w^ 
โปรแกรม	pr oo kr x m^ 
โปรแกรมเมอร์	pr oo kr x m^ m qq 
โผงผาง	ph oo ng^ ph aa ng^ 
โพลง	phl oo ng^ 
โพลีเนเชียน	ph oo l ii n ee ch iia n^ 
โภคภัณฑ์	ph oo k^ k a ph a n^ 
โภชนาการ	ph oo t^ ch a n aa k aa n^ 
โมฆะ	m oo kh a 
โมริ	m oo r i 
โมหะ	m oo h a 
โมโห	m oo h oo 
โยกย้าย	j oo k^ j aa j^ 
โยง	j oo ng^ 
โยงใย	j oo ng^ j a j^ 
โยธา	j oo th aa 
โรการ์ด	r oo k aa t^ 
โรค	r oo k^ 
โรคภัยไข้เจ็บ	r oo k^ ph a j^ kh a j^ c e p^ 
โรคเอดส์	r oo k^ z ee t^ 
โรง	r oo ng^ 
โรงงาน	r oo ng^ ng aa n^ 
โรงพยาบาล	r oo ng^ ph a j aa b aa n^ 
โรงเรียน	r oo ng^ r iia n^ 
โรงเรือน	r oo ng^ r vva n^ 
โรงไฟฟ้า	r oo ng^ f a j^ f aa 
โรจนนิล	r oo t^ c a n a n i n^ 
โรจนเสถียร	r oo t^ c a n a s a th iia n^ 
โรจน์	r oo t^ 
โรมัน	r oo m a n^ 
โรแมนติก	r oo m xx n^ t i k^ 
โลก	l oo k^ 
โลกทัศน์	l oo k^ k a th a t^ 
โลกุตรภูมิ	l oo k u t^ t a r a ph uu m^ 
โลหะ	l oo h a 
โลหิต	l oo h i t^ 
โศก	s oo k^ 
โศกนาฏกรรม	s oo k^ k a n aa t^ t a k a m^ 
โสด	s oo t^ 
โสต	s oo t^ 
โสตสัมผัส	s oo t^ s a m^ ph a t^ 
โสภา	s oo ph aa 
โสร่ง	s a r oo ng^ 
โสเภณี	s oo ph ee n ii 
โหงวเฮ้ง	ng oo w^ h e ng^ 
โหม	h oo m^ 
โหราศาสตร์	h oo r aa s aa t^ 
โหว่	w oo 
โอกาส	z oo k aa t^ 
โอน	z oo n^ 
โอบอุ้ม	z oo p^ z u m^ 
โอวาท	z oo w aa t^ 
โอโซน	z oo s oo n^ 
โอ้อวด	z oo z uua t^ 
โอ๊ค	z oo k^ 
โฮปเวลล์	h oo p^ w e w^ 
ใกล้	kl a j^ 
ใกล้ชิด	kl a j^ ch i t^ 
ใกล้เคียง	kl a j^ kh iia ng^ 
ใคร	khr a j^ 
ใคร่	khr a j^ 
ใคร่รู้	khr a j^ r uu 
ใจ	c a j^ 
ใจกว้าง	c a j^ kw aa ng^ 
ใจความ	c a j^ khw aa m^ 
ใจหาย	c a j^ h aa j^ 
ใจเดียว	c a j^ d iia w^ 
ใช่	ch a j^ 
ใช่ไหม	ch a j^ m a j^ 
ใช้	ch a j^ 
ใช้การ	ch a j^ k aa n^ 
ใช้สอย	ch a j^ s @ j^ 
ใช้สอย	ch a j^ s @@ j^ 
ใช้ได้	ch a j^ d aa j^ 
ใด	d a j^ 
ใต้	t a j^ 
ใต้	t aa j^ 
ใน	n a j^ 
ในเมื่อ	n a j^ m vva 
ใบ	b a j^ 
ใบหน้า	b a j^ n aa 
ใบอนุญาต	b a j^ z a n u j aa t^ 
ใบไม้	b a j^ m a j^ 
ใฝ่	f a j^ 
ใฝ่ฝัน	f a j^ f a n^ 
ใย	j a j^ 
ใส	s a j^ 
ใส่	s a j^ 
ใส่ใจ	s a j^ c a j^ 
ใหญ่	j a j^ 
ใหญ่หลวง	j a j^ l uua ng^ 
ใหญ่โต	j a j^ t oo 
ใหม่	m a j^ 
ให้	h a j^ 
ให้การ	h a j^ k aa n^ 
ให้เปล่า	h a j^ pl a w^ 
ให้แก่	h a j^ k xx 
ไกล	kl a j^ 
ไก่	k a j^ 
ไขว่คว้า	khw a j^ khw aa 
ไขว้เขว	khw a j^ khw ee 
ไข้	kh a j^ 
ไซนัส	s a j^ n a t^ 
ได้	d aa j^ 
ได้มา	d aa j^ m aa 
ได้ยิน	d aa j^ j i n^ 
ได้แก่	d aa j^ k xx 
ไต	t a j^ 
ไตรมาส	tr a j^ m aa t^ 
ไต่เต้า	t a j^ t a w^ 
ไทย	th a j^ 
ไป	p a j^ 
ไพฑูรย์	ph a j^ th uu n^ 
ไพศาล	ph a j^ s aa n^ 
ไพ่	ph a j^ 
ไฟ	f a j^ 
ไฟฟ้า	f a j^ f aa 
ไมตรี	m a j^ tr ii 
ไมโคร	m a j^ khr oo 
ไม่	m a j^ 
ไม่ค่อย	m a j^ kh @ j^ 
ไม่ค่อย	m a j^ kh @@ j^ 
ไม่ชอบมาพากล	m a j^ ch @@ p^ m aa ph aa k o n^ 
ไม่ว่า	m a j^ w aa 
ไม้	m a j^ 
ไม้	m aa j^ 
ไม้ดอก	m aa j^ d @@ k^ 
ไม้ประดับ	m aa j^ pr a d a p^ 
ไยดี	j a j^ d ii 
ไร่	r a j^ 
ไร้	r a j^ 
ไล่	l a j^ 
ไวรัส	w a j^ r a t^ 
ไว้	w a j^ 
ไว้วางใจ	w a j^ w aa ng^ c a j^ 
ไว้ใจ	w a j^ c a j^ 
ไสยศาสตร์	s a j^ j a s aa t^ 
ไหน	n a j^ 
ไหม	m a j^ 
ไหล	l a j^ 
ไหลบ่า	l a j^ b aa 
ไหว	w a j^ 
ไหว้	w a j^ 
ไหว้	w aa j^ 
ไอ้	z a j^ 
